date,rounds,fighter1,fighter2,winner,result_type,judge1,judge1_score1,judge1_score2,judge2,judge2_score1,judge2_score2,judge3,judge3_score1,judge3_score2,judge1_margin,judge2_margin,judge3_margin
2021-12-18,5,Torres,Parnasse,Parnasse,Unanimous,Motylewski,45,50,Muller,46,49,Niemkowicz,47,48,-5,-3,-1
2021-12-18,3,Eskiev,Stasiak,Eskiev,Unanimous,Motylewski,29,27,Paolillo,30,26,Werner,29,28,2,4,1
2021-12-18,3,Bekus,Sormova,Bekus,Unanimous,Motylewski,29,28,Niemkowicz,29,28,Paolillo,29,28,1,1,1
2021-12-18,3,Rewera,Erzanukaev,Erzanukaev,Unanimous,Motylewski,26,30,Muller,27,30,Werner,27,30,-4,-3,-3
2021-12-18,3,Thompson,Muhammad,Muhammad,Unanimous,Bell,25,30,Crosby,26,30,D'Amato,26,30,-5,-4,-4
2021-12-18,3,Lemos,Hill,Lemos,Split,Bell,28,29,Crosby,30,27,Kamijo,29,28,-1,3,1
2021-12-18,3,Ewell,Jourdain,Jourdain,Unanimous,D'Amato,27,30,Kamijo,27,29,Miner,26,30,-3,-2,-4
2021-12-18,3,Niedzwiedz,Broz,draw,Majority,Motylewski,28,28,Paolillo,28,28,Werner,29,28,0,0,1
2021-12-11,3,Figlak,Kauppinen,Figlak,Unanimous,Brown,30,27,Ransom,30,27,Williams,30,27,3,3,3
2021-12-11,3,Richardson,Damiani,Richardson,Unanimous,Barton,29,28,Brown,29,28,Williams,30,27,1,1,3
2021-12-11,3,Figlak,McIntosh,Figlak,Unanimous,Barton,30,26,Brown,30,27,Ransom,30,27,4,3,3
2021-12-11,3,Faiddine,Aby,Aby,Unanimous,Barton,28,29,Ransom,28,29,Williams,26,29,-1,-1,-3
2021-12-11,3,Walls,Stephen,Stephen,Unanimous,Brown,28,29,Ransom,28,29,Williams,28,29,-1,-1,-1
2021-12-11,3,Ponzinibbio,Neal,Neal,Split,Cleary,27,30,Crosby,29,28,D'Amato,28,29,-3,1,-1
2021-12-11,3,Emmett,Ige,Emmett,Unanimous,Crosby,29,28,D'Amato,30,27,Mccarthy,29,28,1,3,1
2021-12-11,3,Munhoz,Cruz,Cruz,Unanimous,Bell,28,29,Cleary,28,29,D'Amato,28,29,-1,-1,-1
2021-12-11,3,Blanchfield,Maverick,Blanchfield,Unanimous,D'Amato,30,27,Lee,30,27,Mccarthy,30,27,3,3,3
2021-12-11,3,Minner,Hall,Hall,Unanimous,Bell,27,30,Colón,27,29,Kamijo,27,30,-3,-2,-3
2021-12-10,5,Melan,Bonner,Melan,Unanimous,Barton,49,44,Brown,48,44,Ransom,49,44,5,4,5
2021-12-10,3,Gittins,Crawford,Crawford,Unanimous,Barton,28,29,Brown,28,29,Ransom,28,29,-1,-1,-1
2021-12-10,3,Mearns,N'Doye,Mearns,Split,Barton,29,28,Ransom,30,27,Williams,28,29,1,3,-1
2021-12-04,5,Aldo,Font,Aldo,Unanimous,Cleary,50,45,D'Amato,49,46,Kamijo,50,45,5,3,5
2021-12-04,3,Gall,Morono,Morono,Unanimous,Byrd,27,30,Cleary,27,30,D'Amato,27,30,-3,-3,-3
2021-12-04,3,Weeks,Barberena,Barberena,Unanimous,Bell,28,29,Kamijo,28,29,Weeks,28,29,-1,-1,-1
2021-12-04,3,Martin,Vlismas,Vlismas,Unanimous,Cleary,28,29,D'Amato,28,29,Hagen,27,30,-1,-1,-3
2021-12-04,3,Menifield,Knight,Knight,Unanimous,Cleary,28,29,Kamijo,28,29,Weeks,28,29,-1,-1,-1
2021-12-03,3,Kennedy,Sanchez,Kennedy,Unanimous,Crosby,30,27,Hagen,30,27,Mccarthy,30,27,3,3,3
2021-12-03,3,Shabliy,King,Shabliy,Unanimous,Hagen,30,27,Peabody,30,27,Rogers,30,27,3,3,3
2021-12-03,3,de Jesus,Kamaka III,Kamaka III,Unanimous,Mccarthy,28,29,Murtha,28,29,Tirelli,28,29,-1,-1,-1
2021-12-03,3,de Jesus,Chokheli,Chokheli,Unanimous,Mccarthy,27,30,Murtha,27,30,Tirelli,28,29,-3,-3,-1
2021-12-03,3,Montalvo,Bohn,Montalvo,Unanimous,Hagen,29,28,Mccarthy,29,28,Rogers,29,27,1,1,2
2021-12-03,3,Mota,Hamel,Hamel,Split,Peabody,29,28,Rogers,27,30,Tirelli,28,29,1,-3,-1
2021-12-03,3,Enkamp,Crutchmer,Crutchmer,Unanimous,Hagen,27,30,Rogers,27,30,Tirelli,27,30,-3,-3,-3
2021-11-20,5,Vieira,Tate,Vieira,Unanimous,Bell,48,47,D'Amato,48,47,Kamijo,49,46,1,1,3
2021-11-20,3,Brady,Chiesa,Brady,Unanimous,Colón,29,28,Crosby,29,28,Kamijo,29,28,1,1,1
2021-11-20,3,Kang,Yahya,Yahya,Unanimous,Crosby,28,29,D'Amato,28,29,Miner,28,29,-1,-1,-1
2021-11-20,3,Grant,Yanez,Yanez,Split,Colón,28,29,Kamijo,28,29,Weeks,30,27,-1,-1,3
2021-11-20,3,Lutz,Sabatini,Sabatini,Unanimous,Byrd,27,30,Colón,26,30,Crosby,27,30,-3,-4,-3
2021-11-20,3,Levy,Garcia,Garcia,Unanimous,D'Amato,28,29,Kamijo,28,29,Miner,28,29,-1,-1,-1
2021-11-20,3,Godinez,Lookboonmee,Godinez,Unanimous,Bell,30,27,D'Amato,30,27,Hagen,30,27,3,3,3
2021-11-20,3,Durden,Aori,Durden,Unanimous,Byrd,29,28,Colón,29,28,D'Amato,29,28,1,1,1
2021-11-20,3,Soriano,Nuerdanbieke,Nuerdanbieke,Unanimous,Crosby,28,29,Miner,28,29,Weeks,28,29,-1,-1,-1
2021-11-20,3,Hughes,Pinheiro,Pinheiro,Unanimous,Bell,28,29,Byrd,27,30,Colón,27,30,-1,-3,-3
2021-11-13,5,Rodriguez,Holloway,Holloway,Unanimous,Cleary,47,48,D'Amato,46,49,Mccarthy,47,48,-1,-3,-1
2021-11-13,3,Jojua,Casey,Casey,Unanimous,Bell,27,30,Kamijo,27,30,Tirelli,27,30,-3,-3,-3
2021-11-12,3,Vassell,Fortune,Vassell,Split,Colón,29,28,Lee,29,28,Wincapaw,28,29,1,1,-1
2021-11-12,3,Pico,Gonzales,Pico,Unanimous,Anderson,30,27,Colón,30,27,Wincapaw,30,26,3,3,4
2021-11-12,3,Blencowe,Sorenson,Blencowe,Unanimous,Lee,30,27,Luxenberg,29,28,Wincapaw,30,27,3,1,3
2021-11-12,3,Yanez,Ellen,Ellen,Split,Anderson,28,29,Lee,29,28,Wincapaw,28,29,-1,1,-1
2021-11-12,3,Turner,Loureda,Loureda,Split,Anderson,29,28,Colón,28,29,Luxenberg,27,30,1,-1,-3
2021-11-12,3,Dereese,Cortes-Acosta,Cortes-Acosta,Unanimous,Anderson,27,30,Luxenberg,27,30,Miner,27,30,-3,-3,-3
2021-11-06,5,Covington,Usman,Usman,Unanimous,Cleary,46,49,D'Amato,47,48,Tirelli,47,48,-3,-1,-1
2021-11-06,5,Zhang,Namajunas,Namajunas,Split,Bell,48,47,Colón,46,49,Crosby,47,48,1,-3,-1
2021-11-06,3,Burgos,Quarantillo,Burgos,Unanimous,Bell,29,28,Cleary,29,28,Crosby,29,28,1,1,1
2021-11-06,3,Gaethje,Chandler,Gaethje,Unanimous,Cleary,29,28,Crosby,30,27,D'Amato,29,28,1,3,1
2021-11-06,3,Allan,Jacoby,Jacoby,Unanimous,Bell,28,29,Crosby,27,30,Tirelli,28,29,-1,-3,-1
2021-11-06,3,Baghdasaryan,Souza,Baghdasaryan,Unanimous,Colón,29,28,Crosby,29,28,D'Amato,29,28,1,1,1
2021-11-06,3,Vergara,Osbourne,Osbourne,Unanimous,Cleary,28,29,Colón,28,29,Tirelli,28,29,-1,-1,-1
2021-11-05,3,Weichel,Carvalho,Carvalho,Unanimous,Cartlidge,28,29,Lee,28,29,Mccarthy,28,29,-1,-1,-1
2021-11-05,3,Bulaid,Sasu,Bulaid,Split,Cartlidge,29,28,Lee,30,27,Mccarthy,28,29,1,3,-1
2021-11-05,3,Hooi,Scatizzi,Scatizzi,Unanimous,Lee,28,29,Mccarthy,28,29,Varela,28,29,-1,-1,-1
2021-11-05,3,Chadwick,Andriuskevicus,Chadwick,Split,Cartlidge,30,27,Mccarthy,29,28,Varela,28,29,3,1,-1
2021-11-05,3,Pallett,Solli,Solli,Split,Cartlidge,29,28,Lee,28,29,Varela,27,30,1,-1,-3
2021-10-30,5,Sandhagen,Yan,Yan,Unanimous,Lethaby,46,49,Ohlsson,46,49,Paolillo,46,49,-3,-3,-3
2021-10-30,3,Volkov,Tybura,Volkov,Unanimous,Paolillo,30,27,Ransom,30,27,Werner,29,28,3,3,1
2021-10-30,3,Oezdemir,Ankalaev,Ankalaev,Unanimous,Cartlidge,28,29,Ransom,27,30,Werner,27,30,-1,-3,-3
2021-10-30,3,Jandiroba,Ribas,Ribas,Unanimous,Cartlidge,28,29,Hughes,28,29,Ohlsson,28,29,-1,-1,-1
2021-10-30,3,Tukhugov,Ramos,Tukhugov,Unanimous,Lethaby,29,28,Paolillo,29,28,Ransom,29,28,1,1,1
2021-10-30,3,Kopylov,Duraev,Duraev,Unanimous,Cartlidge,27,29,Paolillo,27,30,Werner,27,29,-2,-3,-2
2021-10-30,3,Saint Denis,Zaleski dos Santos,Zaleski dos Santos,Unanimous,Lethaby,26,29,Ohlsson,26,29,Werner,26,29,-3,-3,-3
2021-10-30,3,Ulanbekov,Nascimento,Ulanbekov,Split,Cartlidge,28,29,Paolillo,29,28,Ransom,29,28,-1,1,1
2021-10-27,3,Montes,Shields,Montes,Split,Gomez,29,28,Streisand,29,28,Tate,28,29,1,1,-1
2021-10-27,5,Cappelozza,Delija,Cappelozza,Unanimous,Gomez,48,46,Rodriguez,49,45,Wincapaw,49,45,2,4,4
2021-10-27,5,Khaybulaev,Wade,Khaybulaev,Unanimous,Rodriguez,50,45,Streisand,50,45,Tate,50,45,5,5,5
2021-10-27,5,Radzhabov,Manfio,Manfio,Unanimous,Rodriguez,46,49,Tate,46,48,Wincapaw,46,48,-3,-2,-2
2021-10-27,3,Budd,Young,Budd,Unanimous,Gomez,30,27,Rodriguez,30,27,Wincapaw,30,27,3,3,3
2021-10-23,5,Costa,Vettori,Vettori,Unanimous,Cleary,46,48,D'Amato,46,48,Kamijo,46,48,-2,-2,-2
2021-10-23,3,Edwards,Clark,Clark,Unanimous,Colón,28,29,D'Amato,27,30,Mccarthy,27,30,-1,-3,-3
2021-10-23,3,Trinaldo,Grant,Trinaldo,Split,Byrd,29,27,D'Amato,27,29,Mccarthy,29,27,2,-2,2
2021-10-23,3,Onama,Jones,Jones,Unanimous,Colón,28,29,Mccarthy,28,29,Weeks,28,29,-1,-1,-1
2021-10-23,3,Ricci,Oliveira,Ricci,Unanimous,Crosby,30,27,Kamijo,30,27,Weeks,30,27,3,3,3
2021-10-23,3,Staropoli,Pickett,Pickett,Unanimous,Cleary,28,29,D'Amato,27,30,Lee,27,30,-1,-3,-3
2021-10-23,3,Souza,Markos,Markos,Unanimous,Cleary,28,29,Colón,27,30,D'Amato,27,30,-1,-3,-3
2021-10-23,3,Martinez,Lazishvili,Martinez,Unanimous,Byrd,30,27,Crosby,29,28,Mccarthy,29,28,3,1,1
2021-10-23,3,Davlatmurodov,Tokov,Tokov,Split,Bell,28,29,Cartlidge,28,29,Montalvo,29,28,-1,-1,1
2021-10-23,3,Page,Alekseeva,Alekseeva,Unanimous,Bell,27,30,Miner,28,29,Montalvo,27,30,-3,-1,-3
2021-10-23,3,Moore,Mikhailov,Mikhailov,Unanimous,Bell,28,29,Cartlidge,28,29,Montalvo,28,29,-1,-1,-1
2021-10-23,3,Kaczmarczyk,Ruchala,Ruchala,Unanimous,Bonkowski,28,29,Porebski,28,29,Wojciechowski,28,29,-1,-1,-1
2021-10-23,3,Owczarz,Juskiewicz,Juskiewicz,Unanimous,Bonkowski,27,28,Lepicki,26,29,Porebski,26,28,-1,-3,-2
2021-10-23,3,Dawson,Glenn,draw,Majority,Crosby,29,28,Lee,28,28,Mccarthy,28,28,1,0,0
2021-10-23,3,Musaev,Pietrzak,draw,Majority,Motylewski,28,28,Porebski,28,28,Wojciechowski,29,27,0,0,2
2021-10-16,5,Dumont,Ladd,Dumont,Unanimous,D'Amato,49,46,Kamijo,48,47,Lee,49,46,3,1,3
2021-10-16,3,Felipe,Arlovski,Arlovski,Unanimous,Colón,28,29,Crosby,28,29,D'Amato,28,29,-1,-1,-1
2021-10-16,3,Bueno Silva,Fiorot,Fiorot,Unanimous,Colón,27,30,Crosby,27,30,Weeks,26,30,-3,-3,-4
2021-10-16,3,Roberts,Emeev,Roberts,Split,D'Amato,28,29,Lee,30,27,Winter,29,28,-1,3,1
2021-10-16,3,Carolina,Godinez,Carolina,Unanimous,Colón,29,28,D'Amato,29,28,Kamijo,29,28,1,1,1
2021-10-16,3,Henderson,Primus,Primus,Unanimous,Bell,27,30,Hall,28,29,Miner,27,30,-3,-1,-3
2021-10-16,3,Corrales,Parubchenko,Corrales,Unanimous,Curcio,30,27,Mccarthy,30,27,Miner,30,27,3,3,3
2021-10-16,3,Albrektsson,Yagshimuradov,Albrektsson,Unanimous,Bell,29,28,Hall,29,28,Mccarthy,29,28,1,1,1
2021-10-16,3,Torres,Milliard,Torres,Split,Bell,28,29,Curcio,29,28,Mccarthy,29,28,-1,1,1
2021-10-09,5,Dern,Rodriguez,Rodriguez,Unanimous,Bell,46,49,D'Amato,46,49,Kamijo,46,49,-3,-3,-3
2021-10-09,3,Gooden,Brown,Brown,Unanimous,D'Amato,27,30,Hagen,27,30,Winter,27,30,-3,-3,-3
2021-10-09,3,Elliott,Nicolau,Nicolau,Unanimous,Bell,28,29,Kamijo,28,29,Weeks,28,29,-1,-1,-1
2021-10-09,3,Gutierrez,Colares,Gutierrez,Split,Bell,30,27,D'Amato,30,27,Winter,28,29,3,3,-1
2021-10-09,3,Jackson,Rosa,Jackson,Unanimous,Bell,29,27,Byrd,30,27,Hagen,29,28,2,3,1
2021-10-02,3,Figlak,Lister,Figlak,Unanimous,Brown,30,27,Hand,30,27,Ransom,30,27,3,3,3
2021-10-02,3,Hardwick,Deh,Hardwick,Unanimous,Brown,30,26,Hand,30,26,Lethaby,29,27,4,4,2
2021-10-02,3,Hazan,Malone,Hazan,Split,Hand,28,29,Lethaby,29,28,Ransom,29,28,-1,1,1
2021-10-02,5,Walker,Santos,Santos,Unanimous,Cleary,47,48,D'Amato,47,48,Kamijo,47,48,-1,-1,-1
2021-10-02,3,Price,Oliveira,Price,Unanimous,Cleary,29,28,Kamijo,29,28,Weeks,29,28,1,1,1
2021-10-02,3,Jotko,Cirkunov,Jotko,Split,D'Amato,29,28,Hagen,28,29,Lee,29,28,1,-1,1
2021-10-02,3,Solecki,Gordon,Gordon,Split,Cleary,29,28,D'Amato,28,29,Hagen,28,29,1,-1,-1
2021-10-02,3,Rosa,Correia,Rosa,Unanimous,Byrd,30,27,D'Amato,30,27,Lee,30,26,3,3,4
2021-10-01,5,Charriere,Hughes,Hughes,Majority,Brown,45,49,Lethaby,47,47,Ransom,46,48,-4,0,-2
2021-10-01,3,Sheehan,Brown,Sheehan,Split,Brown,29,28,Hand,29,28,Lethaby,28,29,1,1,-1
2021-10-01,3,Page,Lima,Page,Split,Cartlidge,28,29,Colón,29,28,Crosby,29,28,-1,1,1
2021-10-01,3,Borga,McCourt,McCourt,Unanimous,Cartlidge,28,29,Colón,28,29,Crosby,27,30,-1,-1,-3
2021-10-01,3,Landu,Wilde,Wilde,Unanimous,Cartlidge,28,29,Crosby,28,29,Murtha,28,29,-1,-1,-1
2021-10-01,3,Gallon,Mousah,Gallon,Unanimous,Colón,30,27,Crosby,30,27,Murtha,29,28,3,3,1
2021-10-01,3,Diatta,Rose,Diatta,Unanimous,Colón,30,27,Crosby,30,27,Murtha,30,27,3,3,3
2021-10-01,3,Junior,Kakhorov,Kakhorov,Unanimous,Colón,27,30,Crosby,27,30,Murtha,27,30,-3,-3,-3
2021-09-30,3,Evans,Maia,Evans,Unanimous,Brown,29,28,Hand,29,28,Ransom,29,28,1,1,1
2021-09-25,5,Ortega,Volkanovski,Volkanovski,Unanimous,Bell,46,49,D'Amato,44,50,Kamijo,45,50,-3,-6,-5
2021-09-25,3,Blaydes,Rozenstruik,Blaydes,Unanimous,Colón,30,27,Lee,30,27,Weeks,30,27,3,3,3
2021-09-25,3,Hooker,Haqparast,Hooker,Unanimous,Bell,30,27,Byrd,30,26,D'Amato,30,27,3,4,3
2021-09-25,3,Santos,Modafferi,Santos,Unanimous,Bell,30,27,Colón,30,27,D'Amato,30,27,3,3,3
2021-09-25,3,Maximov,Brundage,Maximov,Unanimous,D'Amato,29,28,Hagen,29,28,Miner,29,28,1,1,1
2021-09-18,3,Romero,Davis,Davis,Split,Bell,26,30,Mccarthy,27,30,Valel,29,28,-4,-3,1
2021-09-18,3,Lara,Bennett,Bennett,Unanimous,Mccarthy,26,30,Valel,27,30,Vierra,26,30,-4,-3,-4
2021-09-18,3,Rogers,Karakhanyan,Rogers,Unanimous,Bell,30,27,Hall,30,26,Valel,30,26,3,4,4
2021-09-18,3,Polizzi,Neal,Polizzi,Split,Hall,29,28,Valel,28,29,Vierra,29,28,1,-1,1
2021-09-18,3,Murtazaliev,Adams,Adams,Unanimous,Hall,28,29,Trigg,28,29,Vierra,28,29,-1,-1,-1
2021-09-18,3,Hernandez,Seronio III,Seronio III,Unanimous,Allen,27,29,Bell,26,29,Mccarthy,26,29,-2,-3,-3
2021-09-18,3,Keefe,Gracie,Keefe,Unanimous,Hall,29,28,Herzog,29,28,Vierra,29,28,1,1,1
2021-09-18,3,Delgado,Dillon,Delgado,Unanimous,Allen,30,27,Bell,30,27,Mccarthy,30,27,3,3,3
2021-09-18,3,Clark,Cutelaba,Cutelaba,Unanimous,D'Amato,26,30,Kamijo,26,29,Weeks,27,29,-4,-3,-2
2021-09-18,3,Bohm,Lipski,Lipski,Unanimous,Byrd,27,30,Cleary,27,30,Kamijo,27,30,-3,-3,-3
2021-09-18,3,Nchukwi,Rodriguez,Nchukwi,Unanimous,Cleary,30,27,Colón,30,27,Flores,30,27,3,3,3
2021-09-18,3,Kianzad,Pennington,Pennington,Unanimous,Byrd,28,29,Cleary,28,29,D'Amato,28,29,-1,-1,-1
2021-09-18,3,Jackson,Buys,Jackson,Unanimous,Cleary,30,27,D'Amato,30,27,Weeks,30,27,3,3,3
2021-09-18,3,Alpar,Blanchfield,Blanchfield,Unanimous,Byrd,25,30,Cleary,26,30,Kamijo,25,30,-5,-4,-5
2021-09-18,3,Alateng,Lopez,draw,Unanimous,Cleary,28,28,D'Amato,28,28,Weeks,28,28,0,0,0
2021-09-04,3,Zawada,Morono,Morono,Unanimous,Cleary,27,30,D'Amato,27,30,Miner,27,30,-3,-3,-3
2021-09-04,3,Kim,McCann,McCann,Unanimous,Cleary,28,29,D'Amato,28,29,Kamijo,28,29,-1,-1,-1
2021-09-04,3,Sholinian,Shore,Shore,Unanimous,D'Amato,27,30,Mccarthy,27,30,Miner,27,30,-3,-3,-3
2021-09-04,3,Barriault,Lungiambula,Barriault,Unanimous,Cleary,29,28,D'Amato,29,28,Miner,30,27,1,1,3
2021-09-04,3,Janikowski,Pawlak,Pawlak,Unanimous,Cartlidge,27,30,Porebski,27,30,Wojciechowski,27,30,-3,-3,-3
2021-09-04,3,Stosic,Andryszak,Stosic,Split,Lepicki,28,29,Lethaby,29,28,Niemkowicz,29,28,-1,1,1
2021-09-04,3,Alvarez,Luzar-Smajic,Luzar-Smajic,Unanimous,Lepicki,27,30,Niemkowicz,27,30,Wojciechowski,27,30,-3,-3,-3
2021-09-04,3,Domin,Karolczyk,Domin,Unanimous,Lepicki,29,28,Lethaby,29,28,Wojciechowski,29,28,1,1,1
2021-08-28,3,Turcios,Hiestand,Turcios,Split,Bell,29,28,Cleary,28,29,Weeks,29,28,1,-1,1
2021-08-28,3,Lee,Rodriguez,Rodriguez,Unanimous,D'Amato,28,29,Hagen,28,29,Mccarthy,28,29,-1,-1,-1
2021-08-28,3,Turman,Alvey,Turman,Split,Byrd,27,28,Cleary,28,27,Mccarthy,28,27,-1,1,1
2021-08-28,3,Aldrich,Demopoulos,Aldrich,Unanimous,Cleary,30,27,Hagen,30,27,Mccarthy,30,27,3,3,3
2021-08-28,3,Martinez,Cannetti,Martinez,Split,Byrd,28,29,Cleary,29,28,Kamijo,29,28,-1,1,1
2021-08-27,3,Khaybulaev,Loughnane,Khaybulaev,Split,Rodriguez,29,28,Rupert,30,27,Torres,28,29,1,3,-1
2021-08-27,3,Jenkins,Wade,Wade,Unanimous,Rodriguez,28,29,Rupert,27,30,Wincapaw,27,30,-1,-3,-3
2021-08-27,3,Sordi,Carlos Junior,Carlos Junior,Unanimous,Rupert,27,30,Torres,28,29,Wincapaw,28,29,-3,-1,-1
2021-08-27,3,Camozzi,Hendricks,Camozzi,Unanimous,Rodriguez,30,27,Rupert,29,28,Wincapaw,30,27,3,1,3
2021-08-27,3,Stirn,Dizy,Dizy,Unanimous,Rupert,28,29,Torres,28,29,Wincapaw,28,29,-1,-1,-1
2021-08-27,3,Knight,Moffett,Moffett,Unanimous,Rodriguez,28,29,Torres,28,29,Wincapaw,28,29,-1,-1,-1
2021-08-27,3,Flores,Deaton,Flores,Split,Rodriguez,29,28,Rupert,28,29,Torres,29,28,1,-1,1
2021-08-27,5,Tennant,Verzosa,Tennant,Unanimous,Divilbiss,50,45,Graham,50,45,Mildren,49,46,5,5,3
2021-08-27,3,Tracy,Esquibel,Tracy,Split,Champion,28,29,Graham,29,28,Mildren,29,28,-1,1,1
2021-08-27,3,Mueller,deJesus,deJesus,Split,Divilbiss,29,28,Graham,28,29,Mildren,28,29,1,-1,-1
2021-08-27,3,Sammons,Peralta,Peralta,Unanimous,Champion,27,30,Divilbiss,27,30,Graham,27,30,-3,-3,-3
2021-08-27,3,Messer-Belenchia,Saull,Messer-Belenchia,Split,Divilbiss,29,28,Graham,29,28,Mildren,27,30,1,1,-3
2021-08-27,3,Salcedo,Perez,Salcedo,Unanimous,Champion,30,26,Divilbiss,30,26,Mildren,30,27,4,4,3
2021-08-21,5,Cannonier,Gastelum,Cannonier,Unanimous,Bell,48,47,D'Amato,48,47,Kamijo,48,47,1,1,1
2021-08-21,3,Madsen,Guida,Madsen,Split,Bell,29,28,Colón,30,27,D'Amato,28,29,1,3,-1
2021-08-21,3,Sherman,Porter,Porter,Unanimous,Kamijo,27,30,Weeks,28,29,Winter,27,30,-3,-1,-3
2021-08-21,3,Hubbard,Pichel,Pichel,Unanimous,Byrd,27,30,D'Amato,27,30,Kamijo,27,30,-3,-3,-3
2021-08-21,3,Saldana,Lingo,Lingo,Unanimous,Bell,28,29,Valel,28,29,Winter,28,29,-1,-1,-1
2021-08-21,3,Pilarte,Kelleher,Kelleher,Unanimous,D'Amato,27,30,Kamijo,27,30,Weeks,27,30,-3,-3,-3
2021-08-20,3,Storley,Schiro,Storley,Split,Mccarthy,29,28,Miner,29,28,Valel,28,29,1,1,-1
2021-08-20,3,Aguiar,Johnson,Aguiar,Split,Bell,29,28,Mccarthy,29,28,Ruml,28,29,1,1,-1
2021-08-20,3,Logan,Hamel,Hamel,Unanimous,D'Amato,28,29,Miner,28,29,Valel,27,30,-1,-1,-3
2021-08-19,3,Guardado,Morais,Guardado,Split,Rodriguez,28,29,Rupert,29,28,Tate,29,28,-1,1,1
2021-08-19,3,Goltsov,Delija,Delija,Unanimous,Streisand,28,29,Tate,28,29,Wincapaw,28,29,-1,-1,-1
2021-08-19,3,Dereese,Seumanutafa,Dereese,Unanimous,Rodriguez,29,28,Streisand,30,27,Wincapaw,29,28,1,3,1
2021-08-19,3,Zamora,Mokhnatkina,Mokhnatkina,Unanimous,Rupert,27,30,Tate,27,30,Wincapaw,27,30,-3,-3,-3
2021-08-19,3,Lohsen,Flok,Lohsen,Unanimous,Streisand,29,28,Tate,29,28,Wincapaw,29,28,1,1,1
2021-08-13,3,MacDonald,Cooper III,Cooper III,Unanimous,Green,27,30,Rodriguez,27,30,Tate,27,30,-3,-3,-3
2021-08-13,3,Magomedkerimov,Sy,Magomedkerimov,Unanimous,Green,30,27,Rodriguez,30,27,Rupert,30,27,3,3,3
2021-08-13,3,Collard,Manfio,Manfio,Unanimous,Rodriguez,28,29,Rupert,28,29,Tate,28,29,-1,-1,-1
2021-08-13,3,Martinez,Radzhabov,Radzhabov,Unanimous,Green,28,29,Rupert,27,30,Tate,27,30,-1,-3,-3
2021-08-13,3,Aubin-Mercier,Horcher,Aubin-Mercier,Unanimous,Green,29,28,Rodriguez,30,26,Rupert,29,27,1,4,2
2021-08-13,3,Silva,Umalatov,Umalatov,Unanimous,Green,28,29,Rupert,28,29,Tate,28,29,-1,-1,-1
2021-08-13,3,Homasi,Koreshkov,Koreshkov,Unanimous,Colón,26,30,Peabody,26,30,Tirelli,27,30,-4,-4,-3
2021-08-13,3,Magomedov,Stots,Stots,Unanimous,Hagen,27,30,Miner,27,30,Varela,28,29,-3,-3,-1
2021-08-13,3,Gwerder,Bestaev,Bestaev,Unanimous,Colón,28,29,Peabody,28,29,Varela,28,29,-1,-1,-1
2021-08-13,3,Sorenson,Samad,Sorenson,Split,English,29,28,Montalvo,29,28,Tirelli,28,29,1,1,-1
2021-08-13,3,Glossner,Ruiz,Glossner,Unanimous,Hagen,30,27,Murtha,29,28,Peabody,29,28,3,1,1
2021-08-07,3,Aldo,Munhoz,Aldo,Unanimous,Crosby,30,27,D'Amato,30,27,Lee,30,27,3,3,3
2021-08-07,3,Torres,Hill,Torres,Unanimous,Crosby,30,27,Montalvo,29,28,Rexroad,30,27,3,1,3
2021-08-07,3,Kenney,Yadong,Yadong,Split,D'Amato,28,29,Hatley,29,28,Lee,27,30,-1,1,-3
2021-08-07,3,Fiziev,Green,Fiziev,Unanimous,D'Amato,29,28,Ferraro,30,27,Lee,29,28,1,3,1
2021-08-07,3,Morales,Rodriguez,Morales,Unanimous,Crosby,29,28,Dealejandro,29,28,Hatley,30,27,1,1,3
2021-08-07,3,Herman,Menifield,Menifield,Unanimous,Alexander,27,30,Ferraro,27,30,Patlán,27,30,-3,-3,-3
2021-08-01,3,Morales,Wirth,Morales,Unanimous,Cleary,30,27,D'Amato,30,27,Varela,30,27,3,3,3
2021-08-01,3,Jean-Jacques,Pauga,Pauga,Unanimous,Cleary,28,29,D'Amato,28,29,Miner,28,29,-1,-1,-1
2021-08-01,3,Lynch,Nakagawa,Lynch,Unanimous,Cleary,30,27,Miner,30,27,Varela,30,27,3,3,3
2021-08-01,3,Davis,Marte,Davis,Unanimous,Cleary,30,27,Grice,29,28,Varela,29,28,3,1,1
2021-07-31,5,Hall,Strickland,Strickland,Unanimous,Bell,44,50,Colón,46,49,Kamijo,45,50,-6,-3,-5
2021-07-31,3,Garcia,Gruetzemacher,Gruetzemacher,Unanimous,Hagen,28,29,Mccarthy,28,29,Winter,28,29,-1,-1,-1
2021-07-31,3,Barberena,Witt,Witt,Majority,Bell,27,29,Weeks,28,28,Winter,28,29,-2,0,-1
2021-07-31,3,Frey,Yoder,Frey,Unanimous,Bell,30,27,Mccarthy,30,27,Tirelli,30,27,3,3,3
2021-07-31,3,Benoit,Adashev,Adashev,Unanimous,Colón,27,30,Mccarthy,28,29,Weeks,27,30,-3,-1,-3
2021-07-31,3,Burnell,Sanchez,Burnell,Unanimous,Cleary,29,28,D'Amato,30,27,Miner,30,27,1,3,3
2021-07-31,3,Mamedov,Primus,Mamedov,Split,D'Amato,28,29,Miner,29,28,Varela,29,28,-1,1,1
2021-07-31,3,Porto,Joanne,Porto,Split,Cleary,29,28,Crail,29,28,Denkin,28,29,1,1,-1
2021-07-31,3,Winski,Moore,Moore,Unanimous,Crail,26,30,D'Amato,27,30,Denkin,26,30,-4,-3,-4
2021-07-31,3,Kamaka III,Chavez,draw,Majority,Bell,29,27,Kamijo,28,28,Valel,28,28,2,0,0
2021-07-24,5,Sandhagen,Dillashaw,Dillashaw,Split,Cleary,48,47,D'Amato,47,48,Kamijo,47,48,1,-1,-1
2021-07-24,3,Paiva,Phillips,Paiva,Majority,Colón,29,28,D'Amato,28,28,Lee,29,28,1,0,1
2021-07-24,3,Maverick,Barber,Barber,Split,D'Amato,28,29,Hagen,28,29,Lee,29,28,-1,-1,1
2021-07-24,3,Soriano,Allen,Allen,Unanimous,Hagen,27,30,Kamijo,27,30,Lee,28,29,-3,-3,-1
2021-07-24,3,Belbita,Goldy,Belbita,Unanimous,Cleary,30,27,Kamijo,30,27,Valel,30,27,3,3,3
2021-07-17,3,Sowinski,Rajewski,Rajewski,Split,Bonkowski,28,29,Czajka,28,29,Visnjic,29,28,-1,-1,1
2021-07-17,3,dos Santos,Politylo,dos Santos,Unanimous,Lepicki,29,28,Motylewski,29,28,Niemkowicz,29,28,1,1,1
2021-07-16,3,Morozov,Taha,Morozov,Unanimous,Bell,30,27,Hagen,30,27,Miner,30,27,3,3,3
2021-07-16,3,Figueiredo,Gordon,Gordon,Unanimous,D'Amato,27,30,Kamijo,28,29,Weeks,28,29,-3,-1,-1
2021-07-16,5,Kielholtz,Velasquez,Velasquez,Split,Miner,48,47,Montalvo,47,48,Varela,47,48,1,-1,-1
2021-07-16,3,Eblen,Davis,Eblen,Unanimous,Crosby,30,26,Lee,30,26,Miner,30,27,4,4,3
2021-07-16,3,Avsaragova,Gulfin,Avsaragova,Split,Coffey,28,29,Murtha,29,28,Varela,29,28,-1,1,1
2021-07-16,3,Soto,Benjilany,Benjilany,Unanimous,Crosby,28,29,Lee,28,29,Varela,28,29,-1,-1,-1
2021-07-10,3,Thompson,Burns,Burns,Unanimous,Bell,28,29,D'Amato,28,29,Mccarthy,28,29,-1,-1,-1
2021-07-10,3,Griffin,Condit,Griffin,Unanimous,Cleary,30,27,D'Amato,29,28,Mccarthy,29,28,3,1,1
2021-07-10,3,Pereira,Price,Pereira,Unanimous,Bell,29,28,Byrd,29,28,Kamijo,29,28,1,1,1
2021-07-10,3,Maia,Eye,Maia,Unanimous,Byrd,29,28,Cleary,29,28,D'Amato,30,27,1,1,3
2021-07-10,3,Akhmedov,Tavares,Tavares,Split,Bell,28,29,Colón,28,29,Mccarthy,29,28,-1,-1,1
2021-06-26,5,Machado Garry,Grant,Machado Garry,Unanimous,Cartlidge,50,44,Hand,50,45,Lethaby,50,45,6,5,5
2021-06-26,3,Gomis,Harila,Gomis,Unanimous,Barton,30,27,Cartlidge,29,28,Lethaby,30,27,3,1,3
2021-06-26,5,Gane,Volkov,Gane,Unanimous,D'Amato,49,46,Kamijo,50,45,Mccarthy,50,45,3,5,5
2021-06-26,3,Valiev,Barcelos,Valiev,Majority,Bell,28,28,Mccarthy,29,28,Winter,29,28,0,1,1
2021-06-26,3,Means,Dalby,Means,Unanimous,Bell,29,28,Kamijo,29,28,Weeks,29,28,1,1,1
2021-06-26,3,Rosa,Jaynes,Rosa,Split,Byrd,30,27,Lee,29,28,Mccarthy,28,29,3,1,-1
2021-06-26,3,Medeiros,Hadzovic,Hadzovic,Unanimous,Bell,28,29,Hagen,28,29,Kamijo,28,29,-1,-1,-1
2021-06-25,3,Manfio,Pettis,Manfio,Split,Bilyk,28,29,Carolei,29,28,Tirelli,29,28,-1,1,1
2021-06-25,3,Khaybulaev,Palmer,Khaybulaev,Unanimous,Bilyk,29,28,Carolei,29,28,Tirelli,29,28,1,1,1
2021-06-25,3,Ferreira,Seumanutafa,Ferreira,Unanimous,Bilyk,30,26,Carolei,30,26,Tirelli,30,26,4,4,4
2021-06-25,3,Sanchez,Guardado,Guardado,Unanimous,Carolei,27,30,Tirelli,27,30,Urso,27,30,-3,-3,-3
2021-06-25,3,Young,Morais,Morais,Split,Bilyk,27,30,Sanidad,28,29,Tirelli,29,28,-3,-1,1
2021-06-25,3,Hardwick,N'Doye,Hardwick,Split,Barton,29,28,Cartlidge,28,29,Hand,30,27,1,-1,3
2021-06-25,3,Aimable,Walls,Aimable,Unanimous,Cartlidge,29,28,Hand,30,27,Lethaby,29,28,1,3,1
2021-06-25,3,Leblond,Shanks,Shanks,Unanimous,Barton,28,29,Hand,28,29,Lethaby,28,29,-1,-1,-1
2021-06-25,3,Khalid,Urholin,Urholin,Unanimous,Barton,26,30,Cartlidge,25,30,Lethaby,25,30,-4,-5,-5
2021-06-25,3,Reed,Hazan,Hazan,Unanimous,Barton,28,29,Hand,27,29,Lethaby,26,30,-1,-2,-4
2021-06-25,5,Johnson,Moldavsky,Moldavsky,Unanimous,Colón,46,49,Crosby,45,50,Miner,46,49,-3,-5,-3
2021-06-25,3,Weichel,Diggs,Weichel,Split,Miner,29,28,Peabody,28,29,Varela,30,27,1,-1,3
2021-06-25,3,Biyong,Edwards,Edwards,Unanimous,Cleary,27,30,Colón,27,30,Murtha,27,30,-3,-3,-3
2021-06-25,3,de Jesus,Macapa,de Jesus,Split,English,29,28,Peabody,29,28,Varela,28,29,1,1,-1
2021-06-25,3,Bak,Lee,Bak,Unanimous,Cleary,29,27,Murtha,29,27,Varela,29,27,2,2,2
2021-06-24,3,Currie,Duncan,Duncan,Unanimous,Cartlidge,28,29,Hand,28,29,Lethaby,28,29,-1,-1,-1
2021-06-24,3,Creasey,Aby,Creasey,Unanimous,Barton,30,25,Hand,30,25,Lethaby,30,26,5,5,4
2021-06-19,5,Jung,Ige,Jung,Unanimous,Bell,49,46,Cleary,49,46,D'Amato,48,47,3,3,1
2021-06-19,3,Oleinik,Spivak,Spivak,Unanimous,D'Amato,28,29,Kamijo,28,29,Weeks,28,29,-1,-1,-1
2021-06-19,3,Grant,Vera,Vera,Unanimous,Bell,27,29,Cleary,26,30,Winter,28,29,-2,-4,-1
2021-06-19,3,Negumereanu,Camur,Negumereanu,Split,Bell,29,28,Colón,28,29,Weeks,29,28,1,-1,1
2021-06-19,3,Williams,Semelsberger,Williams,Unanimous,Bell,29,28,Hagen,29,28,Winter,30,27,1,1,3
2021-06-19,3,Martinez,Parisian,Parisian,Split,Colón,29,28,Kamijo,28,29,Weeks,28,29,1,-1,-1
2021-06-17,3,Tibau,MacDonald,Tibau,Split,Colón,28,29,Tirelli,29,28,Urso,29,28,-1,1,1
2021-06-17,3,Cooper III,Aleksakhin,Cooper III,Unanimous,Colón,29,28,Holland,30,27,Tirelli,29,28,1,3,1
2021-06-17,3,Ferreira,Camozzi,Camozzi,Unanimous,Carolei,27,29,Colón,28,29,Tirelli,28,29,-2,-1,-1
2021-06-17,3,Lawlor,Young,Lawlor,Unanimous,Carolei,30,27,Colón,30,27,Tirelli,30,27,3,3,3
2021-06-17,3,Sy,Kunchenko,Sy,Unanimous,Carolei,29,28,Colón,29,28,Holland,29,28,1,1,1
2021-06-17,3,Spohn,Sordi,draw,Unanimous,Carolei,28,28,Holland,28,28,Urso,28,28,0,0,0
2021-06-12,5,Vettori,Adesanya,Adesanya,Unanimous,Cleary,45,50,D'Amato,45,50,Flores,45,50,-5,-5,-5
2021-06-12,5,Edwards,Diaz,Edwards,Unanimous,Cleary,49,46,Frank,49,46,Kamijo,49,46,3,3,3
2021-06-12,3,Maia,Muhammad,Muhammad,Unanimous,D'Amato,27,30,Flores,28,29,Lee,28,29,-3,-1,-1
2021-06-12,3,Dober,Riddell,Riddell,Unanimous,Cleary,28,29,D'Amato,28,29,Frank,28,29,-1,-1,-1
2021-06-12,3,Anders,Stewart,Anders,Unanimous,Bell,29,27,Flores,29,27,Lee,29,28,2,2,1
2021-06-12,3,Wood,Murphy,Murphy,Split,Cleary,29,28,Kamijo,28,29,O'connell,28,29,1,-1,-1
2021-06-12,3,Dawodu,Evloev,Evloev,Unanimous,D'Amato,27,29,Frank,27,29,Lee,27,29,-2,-2,-2
2021-06-12,3,Davis,Kianzad,Kianzad,Unanimous,Bell,28,29,Flores,27,30,Kamijo,27,30,-1,-3,-3
2021-06-12,3,Hooper,Peterson,Peterson,Unanimous,Bell,28,29,Frank,27,30,Lee,27,30,-1,-3,-3
2021-06-12,3,Vendramini,Ziam,Ziam,Majority,Cleary,28,28,Flores,28,29,Kamijo,28,29,0,-1,-1
2021-06-12,3,Felipe,Collier,Felipe,Split,D'Amato,28,29,Lee,29,28,O'connell,29,28,-1,1,1
2021-06-11,5,Amosov,Lima,Amosov,Unanimous,Hagen,49,46,Miner,49,46,Tirelli,50,45,3,3,5
2021-06-11,3,Daley,Jackson,Jackson,Unanimous,Crosby,27,30,Hagen,27,30,Miner,27,30,-3,-3,-3
2021-06-11,3,Crutchmer,Chokheli,Crutchmer,Unanimous,Montalvo,30,27,Murtha,30,27,Valel,30,27,3,3,3
2021-06-11,3,Gonzales,Claxton,Gonzales,Split,Crosby,29,28,Miner,29,28,Tirelli,28,29,1,1,-1
2021-06-11,3,Newell,King,King,Split,Hagen,27,30,Murtha,27,30,Tirelli,29,28,-3,-3,1
2021-06-11,3,Bell,Mokhnatkina,Mokhnatkina,Unanimous,Hagen,27,30,Tirelli,27,30,Varela,27,30,-3,-3,-3
2021-06-10,3,Lutterbach,Collard,Collard,Split,Carolei,28,29,Colón,29,28,Tirelli,28,29,-1,1,-1
2021-06-10,3,Jenkins,Moffett,Jenkins,Unanimous,Holland,29,28,Rugilo,29,28,Urso,29,28,1,1,1
2021-06-10,3,Loughnane,Diamond,Loughnane,Majority,Carolei,28,28,Colón,29,27,Tirelli,30,27,0,2,3
2021-06-10,3,Schulte,Martinez,Schulte,Split,Colón,28,29,Holland,29,28,Rugilo,29,28,-1,1,1
2021-06-10,3,Held,Aubin-Mercier,Aubin-Mercier,Unanimous,Carolei,27,30,Colón,27,30,Tirelli,27,30,-3,-3,-3
2021-06-05,3,Staropoli,Dolidze,Dolidze,Unanimous,Kamijo,27,30,Mccarthy,27,30,Miner,27,30,-3,-3,-3
2021-06-05,3,Baeza,Ponzinibbio,Ponzinibbio,Unanimous,Bell,28,29,D'Amato,28,29,Hagen,28,29,-1,-1,-1
2021-06-05,3,Todorovic,Rodrigues,Rodrigues,Unanimous,Mccarthy,28,29,Weeks,27,30,Winter,27,30,-1,-3,-3
2021-06-05,3,Boser,Latifi,Latifi,Split,Bell,28,29,Kamijo,28,29,Weeks,29,27,-1,-1,2
2021-06-05,3,Salikhov,Trinaldo,Salikhov,Unanimous,Byrd,30,27,D'Amato,30,27,Mccarthy,30,27,3,3,3
2021-06-05,3,Amirkhani,Kirk,Kirk,Unanimous,Bell,28,29,Hagen,27,30,Winter,28,29,-1,-3,-1
2021-06-05,3,Woodson,Zalal,Woodson,Split,Kamijo,29,28,Mccarthy,28,29,Weeks,29,28,1,-1,1
2021-06-05,3,Leavitt,Puelles,Puelles,Unanimous,Byrd,28,29,D'Amato,28,29,Miner,28,29,-1,-1,-1
2021-06-05,3,Desmae,Szymanski,Szymanski,Unanimous,Bonkowski,28,29,Porebski,28,29,Wojciechowski,27,30,-1,-1,-3
2021-06-05,3,Owczarz,Kucinic,Owczarz,Unanimous,Bonkowski,30,27,Porebski,30,27,Werner,29,28,3,3,1
2021-05-22,5,Font,Garbrandt,Font,Unanimous,Cleary,48,47,D'Amato,50,45,Kamijo,50,45,1,5,5
2021-05-22,3,Vanderaa,Tafa,Vanderaa,Unanimous,Bell,30,27,Colón,29,28,Weeks,30,27,3,1,3
2021-05-22,3,Dumont,Spencer,Dumont,Split,D'Amato,30,27,Kamijo,29,28,Miner,28,29,3,1,-1
2021-05-22,3,Ramos,Algeo,Ramos,Unanimous,Bell,30,27,Cleary,29,28,Colón,30,27,3,1,3
2021-05-22,3,Shahbazyan,Hermansson,Hermansson,Unanimous,Byrd,27,29,D'Amato,27,29,Kamijo,27,29,-2,-2,-2
2021-05-22,3,Silva,McGee,McGee,Unanimous,Bell,27,29,Byrd,26,30,Cleary,26,30,-2,-4,-4
2021-05-22,3,Nuerdanbieke,Culibao,Culibao,Unanimous,Cleary,28,29,Hagen,28,29,Miner,28,29,-1,-1,-1
2021-05-22,3,Ismagulov,Alves,Ismagulov,Unanimous,Bell,29,28,Hagen,29,28,Kamijo,29,28,1,1,1
2021-05-21,3,Caldwell,Higo,Higo,Split,Montalvo,29,28,Tirelli,28,29,Varela,28,29,1,-1,-1
2021-05-21,3,Edwards,Vanderford,Vanderford,Unanimous,Crosby,27,30,Montalvo,27,30,Tirelli,27,30,-3,-3,-3
2021-05-21,3,Mendonca,Willis,Willis,Unanimous,Montalvo,28,29,Tirelli,27,30,Varela,28,29,-1,-3,-1
2021-05-21,3,Loureda,Guy,Guy,Unanimous,Montalvo,28,29,Tirelli,28,29,Varela,27,30,-1,-1,-3
2021-05-21,3,Johns,Sabatello,Sabatello,Unanimous,Coffey,27,30,Murtha,27,30,Varela,27,30,-3,-3,-3
2021-05-21,3,Davis,Shabliy,Shabliy,Unanimous,Crosby,27,30,Montalvo,27,30,Tirelli,27,30,-3,-3,-3
2021-05-21,5,Rodriguez,Torquato,Rodriguez,Unanimous,Champion,50,45,Graham,49,46,Sutherland,48,47,5,3,1
2021-05-21,5,Delboni,Zappitella,Zappitella,Split,Champion,47,48,Graham,47,48,Sutherland,48,47,-1,-1,1
2021-05-21,3,Storts,Favela,Storts,Unanimous,Champion,29,28,Graham,29,28,Sutherland,29,28,1,1,1
2021-05-21,3,Miller,Guthrie,Guthrie,Unanimous,Champion,28,29,Graham,27,30,Sutherland,27,30,-1,-3,-3
2021-05-15,3,Dariush,Ferguson,Dariush,Unanimous,D'Amato,30,27,Lee,30,27,Rosales,30,27,3,3,3
2021-05-15,3,Bontorin,Schnell,Bontorin,Unanimous,D'Amato,30,27,Dealejandro,29,28,Ferraro,30,27,3,1,3
2021-05-15,3,Chookagian,Araujo,Chookagian,Unanimous,Lee,29,28,Rexroad,29,28,Rosales,30,27,1,1,3
2021-05-15,3,Grundy,Vannata,Vannata,Split,Lee,28,29,Patlán,30,27,Rosales,27,30,-1,3,-3
2021-05-15,3,Aguilar,Lutz,Lutz,Unanimous,Dealejandro,28,29,Ferraro,27,30,Rosales,28,29,-1,-3,-1
2021-05-08,5,Rodriguez,Waterson-Gomez,Rodriguez,Unanimous,Cleary,48,47,D'Amato,49,46,Mccarthy,49,46,1,3,3
2021-05-08,3,Magny,Neal,Magny,Unanimous,Cleary,29,28,D'Amato,29,28,Mccarthy,30,27,1,1,3
2021-05-08,3,de Lima,Greene,de Lima,Unanimous,Kamijo,30,26,Lee,30,27,Weeks,30,26,4,3,4
2021-05-08,3,Hawes,Daukaus,Hawes,Unanimous,Bell,30,26,D'Amato,29,27,Weeks,30,26,4,2,4
2021-05-08,3,Trizano,Klein,Trizano,Unanimous,Byrd,29,28,Cleary,29,28,Kamijo,30,27,1,1,3
2021-05-08,3,Nchukwi,Park,Park,Majority,D'Amato,26,29,Mccarthy,25,30,Weeks,28,28,-3,-5,0
2021-05-07,5,Archuleta,Pettis,Pettis,Unanimous,Miner,46,49,Montalvo,45,50,Peabody,46,49,-3,-5,-3
2021-05-07,3,Stots,Hill,Stots,Unanimous,Beltran,30,27,Montalvo,30,27,Varela,30,27,3,3,3
2021-05-07,3,Carvalho,Larkin,Larkin,Split,Crosby,28,29,Montalvo,28,29,Peabody,29,28,-1,-1,1
2021-05-07,3,Soto,Almeida,Soto,Unanimous,Montalvo,29,28,Peabody,29,28,Varela,29,27,1,1,2
2021-05-07,3,Shutt,Perez,Perez,Unanimous,Anderson,26,30,Miner,27,30,Varela,27,30,-4,-3,-3
2021-05-06,3,Dandois,Young,Young,Unanimous,Carolei,27,30,Colón,27,30,Holland,27,30,-3,-3,-3
2021-05-06,3,Fabian,Sanchez,Fabian,Unanimous,Colón,30,27,Rugilo,30,27,Tirelli,30,27,3,3,3
2021-05-06,3,Guardado,Kolesnyk,Guardado,Unanimous,Colón,30,26,Rugilo,30,26,Tirelli,29,27,4,4,2
2021-05-01,3,Strickland,Jotko,Strickland,Unanimous,Byrd,29,28,D'Amato,30,27,Kamijo,30,27,1,3,3
2021-05-01,3,Stamann,Dvalishvili,Dvalishvili,Unanimous,Bell,27,30,D'Amato,28,29,Winter,28,29,-3,-1,-1
2021-05-01,3,Kamaka III,Brown,Brown,Split,Bell,28,29,Byrd,30,27,D'Amato,28,29,-1,3,-1
2021-05-01,3,Carolina,Botelho,Carolina,Split,D'Amato,28,29,Hagen,29,28,Kamijo,29,28,-1,1,1
2021-05-01,3,Lookboonmee,Hughes,Lookboonmee,Unanimous,Bell,29,28,Hagen,29,28,Kamijo,29,28,1,1,1
2021-05-01,3,Bhullar,Michailidis,Michailidis,Unanimous,Colón,28,29,Weeks,27,30,Winter,27,30,-1,-3,-3
2021-05-01,3,Colares,Sanders,Colares,Unanimous,Bell,29,28,Byrd,29,28,Kamijo,29,28,1,1,1
2021-05-01,3,Jacoby,Cutelaba,draw,Split,Hagen,29,28,Weeks,28,28,Winter,28,29,1,0,-1
2021-04-29,3,Tibau,Zeferino,Zeferino,Unanimous,Carolei,28,29,Colón,28,29,Holland,28,29,-1,-1,-1
2021-04-29,3,Sordi,Camozzi,Sordi,Unanimous,Carolei,29,28,Colón,29,28,Holland,28,27,1,1,1
2021-04-24,3,Kaczmarczyk,Sobiech,Kaczmarczyk,Unanimous,Czajka,29,28,Motylewski,29,28,Niemkowicz,29,28,1,1,1
2021-04-24,3,Rola,Wojcik,Wojcik,Unanimous,Czajka,28,29,Lepicki,28,29,Motylewski,28,29,-1,-1,-1
2021-04-24,3,Surdyn,Wiklacz,Wiklacz,Unanimous,Czajka,25,30,Lepicki,25,30,Niemkowicz,25,30,-5,-5,-5
2021-04-24,3,Grant,Sekulic,Grant,Split,Cleary,28,29,Lee,29,28,Reichbach,29,28,-1,1,1
2021-04-24,3,Sabatini,Connelly,Sabatini,Unanimous,Colón,29,28,Lee,30,27,Wincapaw,29,28,1,3,1
2021-04-24,3,Vargas,Zhu,Vargas,Unanimous,Colón,29,28,Reichbach,29,28,Wincapaw,30,26,1,1,4
2021-04-24,3,Aori,Molina,Molina,Unanimous,D'Amato,28,29,Luxenberg,28,29,Weeks,27,29,-1,-1,-2
2021-04-23,3,Collard,Pettis,Collard,Unanimous,Carolei,29,27,Tirelli,29,27,Urso,29,28,2,2,1
2021-04-23,3,Held,Schulte,Held,Unanimous,Bilyk,29,28,Carolei,29,28,Tirelli,29,28,1,1,1
2021-04-23,3,Khaybulaev,Stojadinovic,Khaybulaev,Unanimous,Bilyk,30,27,Tirelli,30,27,Urso,30,27,3,3,3
2021-04-23,3,Jenkins,Palmer,Jenkins,Unanimous,Carolei,30,27,Sanidad,30,27,Urso,30,27,3,3,3
2021-04-23,3,Manfio,Lutterbach,Manfio,Split,Bilyk,28,29,Sanidad,29,28,Urso,29,28,-1,1,1
2021-04-23,3,Aliev,Odintsov,Aliev,Unanimous,Bilyk,29,28,Carolei,29,28,Tirelli,29,28,1,1,1
2021-04-23,3,Dizy,Wade,Wade,Unanimous,Bilyk,28,29,Tirelli,28,29,Urso,28,29,-1,-1,-1
2021-04-23,3,Jo,Diamond,Diamond,Unanimous,Bilyk,27,30,Carolei,27,30,Sanidad,27,30,-3,-3,-3
2021-04-23,3,Martinez,Radzhabov,Martinez,Split,Carolei,28,29,Sanidad,29,28,Urso,30,27,-1,1,3
2021-04-17,5,Gastelum,Whittaker,Whittaker,Unanimous,Bell,45,50,Cleary,45,50,D'Amato,45,50,-5,-5,-5
2021-04-17,3,Arlovski,Sherman,Arlovski,Unanimous,Bell,29,28,Cleary,29,28,Weeks,29,28,1,1,1
2021-04-17,3,Malkoun,Alhassan,Malkoun,Unanimous,Byrd,30,27,Kamijo,30,27,Lee,30,27,3,3,3
2021-04-17,3,Cortez,Kish,Cortez,Split,Cleary,29,28,D'Amato,28,29,Winter,30,27,1,-1,3
2021-04-17,3,Pena,Munoz,Pena,Split,Bell,28,29,D'Amato,29,28,Winter,29,28,-1,1,1
2021-04-17,3,Espino,Romanov,Romanov,Split,Hagen,28,29,Lee,29,28,Weeks,28,29,-1,1,-1
2021-04-17,3,Godinez,Penne,Penne,Split,Bell,28,29,Cleary,28,29,Winter,29,28,-1,-1,1
2021-04-17,3,Bush,Hubbard,Hubbard,Unanimous,Cleary,28,29,Kamijo,28,29,Weeks,28,29,-1,-1,-1
2021-04-16,5,Davis,Nemkov,Nemkov,Unanimous,Mccarthy,47,48,Miner,47,48,Montalvo,47,48,-1,-1,-1
2021-04-16,3,Yanez,Arteaga,Arteaga,Majority,Colón,28,28,Mccarthy,27,29,Tirelli,27,29,0,-2,-2
2021-04-16,3,Budd,Silva,Budd,Split,Colón,29,28,Mccarthy,29,28,Miner,28,29,1,1,-1
2021-04-16,3,Milliard,Anglickas,Anglickas,Unanimous,Colón,28,29,Miner,27,30,Murtha,27,30,-1,-3,-3
2021-04-16,3,Jackson,Bozinyan,Bozinyan,Unanimous,Crosby,27,30,Mccarthy,28,29,Miner,28,29,-3,-1,-1
2021-04-16,3,Stanonik,Daniels,Daniels,Unanimous,Montalvo,26,30,Murtha,27,30,Tirelli,26,30,-4,-3,-4
2021-04-16,3,Surin,Gibson Jr.,Gibson Jr.,Unanimous,Miner,28,29,Peabody,27,30,Tirelli,27,30,-1,-3,-3
2021-04-16,3,Nemkov,Albrektsson,Albrektsson,Unanimous,Crosby,27,30,Peabody,27,30,Tirelli,27,30,-3,-3,-3
2021-04-10,5,Holland,Vettori,Vettori,Unanimous,Cleary,44,50,D'Amato,44,50,Kamijo,44,50,-6,-6,-6
2021-04-10,3,Yusuff,Allen,Allen,Unanimous,Bell,28,29,D'Amato,28,29,Winter,28,29,-1,-1,-1
2021-04-10,3,Perry,Rodriguez,Rodriguez,Unanimous,Cleary,27,30,Kamijo,27,30,Weeks,26,30,-3,-3,-4
2021-04-10,3,Solecki,Miller,Solecki,Unanimous,Bell,29,28,Byrd,30,27,Kamijo,29,28,1,3,1
2021-04-10,3,Bahamondes,Makdessi,Makdessi,Split,Cleary,29,28,D'Amato,28,29,Hagen,27,30,1,-1,-3
2021-04-10,3,Azure,Shore,Shore,Split,Bell,27,30,D'Amato,27,30,Hagen,29,28,-3,-3,1
2021-04-10,3,Saldana,Griffin,Saldana,Unanimous,Byrd,29,28,Cleary,29,28,Kamijo,29,28,1,1,1
2021-04-10,3,Knight,Jung,Jung,Unanimous,D'Amato,26,30,Weeks,27,30,Winter,26,30,-4,-3,-4
2021-04-09,5,Bader,Machida,Bader,Unanimous,Colón,49,46,Miner,49,45,Peabody,49,45,3,4,4
2021-04-09,3,Porto,Carmouche,Carmouche,Unanimous,Colón,27,30,Crosby,27,30,Tirelli,28,29,-3,-3,-1
2021-04-09,3,Kennedy,Borics,Borics,Unanimous,Colón,28,29,Miner,27,30,Peabody,28,29,-1,-3,-1
2021-04-09,3,Moret,Yamauchi,Moret,Split,Crosby,29,28,Miner,28,29,Rogers,29,28,1,-1,1
2021-04-09,3,Rosta,Johnson,Rosta,Unanimous,Crosby,30,27,Miner,30,27,Murtha,30,27,3,3,3
2021-04-09,3,Nogueira,Borga,Nogueira,Unanimous,Colón,29,27,Miner,29,27,Tirelli,29,27,2,2,2
2021-04-09,3,Lugo,Bell,Lugo,Unanimous,Crosby,30,26,Miner,30,27,Peabody,30,27,4,3,3
2021-04-09,3,Law,Ghareeb,Law,Unanimous,Crosby,30,27,Rogers,30,27,Tirelli,30,27,3,3,3
2021-04-09,3,William,Dung,Dung,Unanimous,Colón,28,29,Peabody,28,29,Rogers,27,30,-1,-1,-3
2021-04-09,3,Douma,Smith,Douma,Split,Colón,28,29,Crosby,29,28,Rogers,29,28,-1,1,1
2021-04-02,3,Gracie,Jackson,Jackson,Unanimous,Bell,28,29,Colón,28,29,D'Amato,28,29,-1,-1,-1
2021-04-02,3,Nurmagomedov,Hamel,Nurmagomedov,Unanimous,Bell,30,27,Crosby,29,28,D'Amato,30,27,3,1,3
2021-04-02,3,Watanabe,Lara,Watanabe,Split,Bell,29,28,D'Amato,29,28,Miner,28,29,1,1,-1
2021-04-02,3,Aguiar,Murtazaliev,Murtazaliev,Unanimous,Bell,28,29,Crosby,27,30,Miner,27,30,-1,-3,-3
2021-03-27,3,Maverick,Robertson,Maverick,Unanimous,Bell,30,27,Colón,29,28,D'Amato,30,27,3,1,3
2021-03-27,3,Gooden,Nurmagomedov,Nurmagomedov,Unanimous,Bell,27,30,Cleary,27,30,Hagen,27,30,-3,-3,-3
2021-03-27,3,Bukauskas,Oleksiejczuk,Oleksiejczuk,Split,Colón,29,28,Mccarthy,28,29,Weeks,28,29,1,-1,-1
2021-03-27,3,Young,Morales,Morales,Unanimous,D'Amato,27,30,Hagen,27,30,Kamijo,27,30,-3,-3,-3
2021-03-20,5,Holland,Brunson,Brunson,Unanimous,Bell,45,49,D'Amato,46,49,Kamijo,46,49,-4,-3,-3
2021-03-20,3,Conejo,Vlismas,Conejo,Unanimous,Bell,29,28,Kamijo,29,28,Miner,29,27,1,1,2
2021-03-20,3,Reneau,Chiasson,Chiasson,Unanimous,Bell,28,29,D'Amato,28,29,Winter,28,29,-1,-1,-1
2021-03-20,3,Giles,Dolidze,Giles,Unanimous,Byrd,29,28,Colón,29,28,Miner,29,28,1,1,1
2021-03-20,5,Charriere,Vucenic,Vucenic,Split,Cartlidge,49,46,Hand,47,48,Lethaby,47,48,3,-1,-1
2021-03-20,3,Belhadj,Mearns,Belhadj,Unanimous,Barton,29,28,Hand,29,28,Lethaby,29,28,1,1,1
2021-03-20,5,Przybysz,Racic,Przybysz,Unanimous,Bonkowski,49,46,Niemkowicz,48,47,Porebski,49,46,3,1,3
2021-03-20,3,Pietrzak,Kaszubowski,Pietrzak,Split,Lepicki,29,28,Niemkowicz,28,29,Porebski,29,28,1,-1,1
2021-03-20,3,Rajewski,Dyrschka,Rajewski,Unanimous,Bonkowski,29,28,Lepicki,29,28,Porebski,30,27,1,1,3
2021-03-20,3,Rajewski,Lazic,Rajewski,Unanimous,Bonkowski,30,27,Lepicki,30,27,Niemkowicz,30,27,3,3,3
2021-03-20,3,Wieczorek,Likus,Likus,Unanimous,Lepicki,27,30,Niemkowicz,27,30,Porebski,27,30,-3,-3,-3
2021-03-19,5,Sardari,Desmae,Sardari,Split,Cartlidge,48,47,Hand,48,47,Lethaby,47,48,1,1,-1
2021-03-18,3,Kauppinen,Richardson,Kauppinen,Unanimous,Cartlidge,29,28,Hand,29,28,Lethaby,29,28,1,1,1
2021-03-18,3,Hughes,Hendin,Hughes,Unanimous,Barton,29,28,Cartlidge,29,28,Lethaby,29,28,1,1,1
2021-03-18,3,Elliott,Pedersen,Elliott,Unanimous,Barton,29,28,Hand,29,28,Lethaby,29,28,1,1,1
2021-03-18,3,McAleenan,Lister,draw,Split,Cartlidge,28,28,Hand,29,28,Lethaby,28,29,0,1,-1
2021-03-13,3,Kape,Nicolau,Nicolau,Split,Hagen,29,28,Lee,28,29,Miner,28,29,1,-1,-1
2021-03-13,3,Hill,Yoder,Hill,Unanimous,Bell,30,27,D'Amato,30,27,Winter,30,27,3,3,3
2021-03-13,3,Haqparast,Garcia,Haqparast,Unanimous,Kamijo,29,28,Lee,30,27,Weeks,29,28,1,3,1
2021-03-13,3,Aldrich,Casey,Aldrich,Split,Bell,29,28,D'Amato,28,29,Winter,29,28,1,-1,1
2021-03-13,3,Frey,de Paula,Frey,Unanimous,D'Amato,29,28,Lee,29,28,Miner,29,28,1,1,1
2021-03-06,5,Adesanya,Blachowicz,Blachowicz,Unanimous,Cleary,45,49,D'Amato,46,49,Kamijo,45,49,-4,-3,-4
2021-03-06,3,Rakic,Santos,Rakic,Unanimous,Colón,29,28,Hagen,29,28,Mccarthy,30,27,1,1,3
2021-03-06,3,Cruz,Kenney,Cruz,Split,Bell,28,29,Cleary,29,28,D'Amato,30,27,-1,1,3
2021-03-06,3,Yadong,Phillips,Phillips,Unanimous,Colón,28,29,Lee,28,29,Mccarthy,28,29,-1,-1,-1
2021-03-06,3,Benavidez,Askarov,Askarov,Unanimous,Cleary,27,30,D'Amato,26,30,Weeks,27,30,-3,-4,-3
2021-03-06,3,Espinosa,Elliott,Elliott,Unanimous,Bell,27,30,D'Amato,27,30,Lee,25,30,-3,-3,-5
2021-02-27,5,Gane,Rozenstruik,Gane,Unanimous,Cleary,50,45,D'Amato,50,45,Kamijo,50,45,5,5,5
2021-02-27,3,Krylov,Ankalaev,Ankalaev,Unanimous,Bell,28,29,Lee,28,29,Mccarthy,28,29,-1,-1,-1
2021-02-27,3,Rivera,Munhoz,Munhoz,Unanimous,Bell,28,29,Kamijo,27,30,Mccarthy,27,30,-1,-3,-3
2021-02-27,3,Caceres,Croom,Caceres,Unanimous,Colón,30,26,Lee,30,26,Weeks,30,27,4,4,3
2021-02-27,3,Moises,Hernandez,Moises,Unanimous,Colón,30,27,Hagen,30,27,Mccarthy,29,28,3,3,1
2021-02-27,3,Mazo,Davis,Davis,Unanimous,Bell,27,30,Cleary,26,30,Weeks,27,30,-3,-4,-3
2021-02-27,3,Jacoby,Grishin,Jacoby,Unanimous,Bell,29,28,D'Amato,29,28,Weeks,29,28,1,1,1
2021-02-27,3,Bueno Silva,De La Rosa,draw,Majority,Cleary,28,28,Colón,28,27,D'Amato,28,28,0,1,0
2021-02-20,3,Vieira,Kunitskaya,Kunitskaya,Unanimous,Colón,28,29,D'Amato,28,29,Kamijo,28,29,-1,-1,-1
2021-02-20,3,Rosa,Minner,Minner,Unanimous,Bell,26,30,Lee,27,29,Winter,27,30,-4,-2,-3
2021-02-20,3,Hawes,Imavov,Hawes,Majority,Bell,29,28,Kamijo,28,28,Lee,29,28,1,0,1
2021-02-20,3,Gordon,Chavez,Gordon,Unanimous,Colón,30,27,Kamijo,30,27,Lee,29,28,3,3,1
2021-02-13,3,Grasso,Barber,Grasso,Unanimous,Colón,29,28,D'Amato,29,28,Kamijo,29,28,1,1,1
2021-02-13,3,Heinisch,Gastelum,Gastelum,Unanimous,Cleary,28,29,Mccarthy,27,30,Miner,28,29,-1,-3,-1
2021-02-13,3,Kelleher,Simon,Simon,Unanimous,D'Amato,27,30,Mccarthy,27,30,Weeks,27,30,-3,-3,-3
2021-02-13,3,Muhammad,Lima,Muhammad,Unanimous,Cleary,30,27,D'Amato,30,27,Valel,30,27,3,3,3
2021-02-13,3,Ewell,Gutierrez,Gutierrez,Unanimous,D'Amato,27,30,Kamijo,26,30,Mccarthy,28,29,-3,-4,-1
2021-02-13,3,Green,Rowe,Green,Unanimous,Colón,29,28,Hagen,29,28,Weeks,30,27,1,1,3
2021-02-06,3,Guida,Johnson,Guida,Unanimous,Kamijo,30,27,Lee,30,27,Weeks,30,27,3,3,3
2021-02-06,3,Pantoja,Kape,Pantoja,Unanimous,Lee,29,28,Valel,30,27,Winter,29,28,1,3,1
2021-02-06,3,Ferreira,Dariush,Dariush,Split,Hagen,28,29,Lee,28,29,Valel,29,28,-1,-1,1
2021-02-06,3,Edwards,Rosa,Rosa,Unanimous,Byrd,27,30,Kamijo,27,30,Lee,27,30,-3,-3,-3
2021-02-06,3,McCann,Procopio,Procopio,Unanimous,D'Amato,27,29,Lee,28,29,Valel,27,30,-2,-1,-3
2021-02-06,3,Zalal,Choi,Choi,Unanimous,Byrd,27,30,D'Amato,28,29,Kamijo,28,29,-3,-1,-1
2021-02-06,3,Valiev,Day,Valiev,Unanimous,Valel,30,25,Weeks,30,26,Winter,30,25,5,4,5
2021-01-30,3,Musaev,Jurisic,Musaev,Unanimous,Bonkowski,30,27,Porebski,30,27,Wojciechowski,30,27,3,3,3
2021-01-30,3,Martinik,Politylo,Politylo,Unanimous,Bonkowski,27,30,Niemkowicz,27,30,Porebski,27,30,-3,-3,-3
2021-01-30,3,Barrio,Kopera,Barrio,Unanimous,Niemkowicz,29,28,Porebski,29,28,Wojciechowski,30,27,1,1,3
2021-01-23,3,Wood,Eye,Wood,Unanimous,Cartlidge,29,28,Colón,30,27,Ohlsson,30,27,1,3,3
2021-01-23,3,Tsarukyan,Frevola,Tsarukyan,Unanimous,Colón,30,26,D'Amato,30,27,Werner,30,27,4,3,3
2021-01-23,3,Tavares,Carlos Junior,Tavares,Unanimous,Cartlidge,30,27,Lethaby,29,28,Ohlsson,30,27,3,1,3
2021-01-23,3,Prachnio,Rountree Jr.,Prachnio,Unanimous,Cartlidge,29,28,Colón,29,28,Ohlsson,29,28,1,1,1
2021-01-23,3,Lentz,Evloev,Evloev,Split,Cartlidge,28,29,Colón,29,28,Sutherland,28,29,-1,1,-1
2021-01-23,3,Albazi,Zhumagulov,Albazi,Unanimous,Bell,29,28,Ohlsson,29,28,Werner,29,28,1,1,1
2021-01-20,5,Magny,Chiesa,Chiesa,Unanimous,Bell,46,49,D'Amato,46,49,Lethaby,46,49,-3,-3,-3
2021-01-20,3,Modafferi,Araujo,Araujo,Unanimous,D'Amato,27,30,Lethaby,27,30,Werner,26,30,-3,-3,-4
2021-01-20,3,Schnell,Nam,Schnell,Split,Bell,29,28,Colón,28,29,Ohlsson,29,28,1,-1,1
2021-01-20,3,Silva de Andrade,Murphy,Murphy,Unanimous,Cartlidge,28,29,Lethaby,28,29,Sutherland,27,30,-1,-1,-3
2021-01-20,3,Mudaerji,Adashev,Mudaerji,Unanimous,Colón,29,28,D'Amato,29,28,Werner,30,27,1,1,3
2021-01-20,3,Lungiambula,Perez,Lungiambula,Unanimous,Bell,29,28,Ohlsson,29,28,Sutherland,29,28,1,1,1
2021-01-20,3,Rivera,Figueiredo,Figueiredo,Unanimous,Cartlidge,28,29,Lethaby,28,29,Werner,28,29,-1,-1,-1
2021-01-20,3,Davis,Jones,Davis,Unanimous,Colón,29,28,D'Amato,29,28,Ohlsson,29,28,1,1,1
2021-01-16,5,Holloway,Kattar,Holloway,Unanimous,Bell,50,43,Cartlidge,50,43,Lethaby,50,42,7,7,8
2021-01-16,3,Condit,Brown,Condit,Unanimous,Ohlsson,30,27,Sutherland,30,27,Werner,30,27,3,3,3
2021-01-16,3,Edwards,Yanan,Edwards,Unanimous,Bosacki,30,27,Cartlidge,29,28,Ohlsson,30,27,3,1,3
2021-01-16,3,Tafa,Felipe,Felipe,Split,Bosacki,28,29,Ohlsson,29,28,Sutherland,28,29,-1,1,-1
2021-01-16,3,Emeev,Zawada,Emeev,Split,Bell,28,29,Cartlidge,29,28,Lethaby,29,28,-1,1,1
2021-01-16,3,Moras,Melo,Melo,Unanimous,Bosacki,27,30,Ohlsson,28,29,Werner,28,29,-3,-1,-1
2021-01-16,3,Lingo,Kilburn,Lingo,Unanimous,Cartlidge,30,27,Lethaby,30,26,Sutherland,30,26,3,4,4
2020-12-19,3,Mankowski,Sowinski,Mankowski,Unanimous,Bonkowski,29,27,Niemkowicz,30,25,Porebski,30,26,2,5,4
2020-12-19,5,dos Santos,Racic,Racic,Unanimous,Bonkowski,47,48,Niemkowicz,47,48,Porebski,47,48,-1,-1,-1
2020-12-19,3,Odzimkowski,Eckerlin,Eckerlin,Split,Lepicki,28,29,Niemkowicz,28,29,Porebski,29,28,-1,-1,1
2020-12-19,5,Neal,Thompson,Thompson,Unanimous,Cleary,45,50,D'Amato,45,50,Kamijo,45,50,-5,-5,-5
2020-12-19,3,Vera,Aldo,Aldo,Unanimous,Bell,28,29,Colón,28,29,Mccarthy,28,29,-1,-1,-1
2020-12-19,3,Williams,Pereira,Pereira,Unanimous,Bell,28,29,Colón,28,29,Weeks,28,29,-1,-1,-1
2020-12-19,3,Pettis,Morono,Pettis,Unanimous,Cleary,29,28,Colón,29,28,Mccarthy,29,28,1,1,1
2020-12-19,3,Kianzad,Eubanks,Kianzad,Unanimous,Cleary,29,28,D'Amato,29,28,Kamijo,29,28,1,1,1
2020-12-19,3,Arroyo,Winn,Winn,Unanimous,Cleary,28,29,D'Amato,28,29,Weeks,28,29,-1,-1,-1
2020-12-19,3,Robertson,Santos,Santos,Unanimous,Cleary,26,30,Hagen,28,29,Lee,26,30,-4,-1,-4
2020-12-19,3,Pickett,Nchukwi,Nchukwi,Unanimous,Bell,26,30,Colón,25,30,Lee,26,30,-4,-5,-4
2020-12-19,3,Minus,Giagos,Giagos,Unanimous,D'Amato,26,30,Hagen,27,29,Kamijo,28,29,-4,-2,-1
2020-12-12,3,Ferguson,Oliveira,Oliveira,Unanimous,Bell,26,30,Colón,26,30,Mccarthy,26,30,-4,-4,-4
2020-12-12,3,Dern,Jandiroba,Dern,Unanimous,Cleary,29,28,D'Amato,29,28,Kamijo,29,28,1,1,1
2020-12-12,3,Quarantillo,Tucker,Tucker,Unanimous,Hagen,27,30,Lee,27,30,Mccarthy,27,30,-3,-3,-3
2020-12-12,5,Grant,Sardari,Sardari,Split,Barton,48,47,Hand,47,48,Ransom,46,49,1,-1,-3
2020-12-12,3,Hughes,Vucenic,Vucenic,Split,Goddard,29,28,Hand,28,29,Ransom,28,29,1,-1,-1
2020-12-12,3,Bellandi,Currie,Currie,Unanimous,Barton,26,30,Hand,26,30,Ransom,27,30,-4,-4,-3
2020-12-12,5,Moreno,Figueiredo,draw,Majority,Cleary,46,48,D'Amato,47,47,Kamijo,47,47,-2,0,0
2020-12-11,3,Damiani,Khalid,Damiani,Split,Barton,29,28,Hand,29,28,Ransom,28,29,1,1,-1
2020-12-11,3,Inman,Bonner,Bonner,Unanimous,Barton,27,30,Hand,27,30,Ransom,28,29,-3,-3,-1
2020-12-11,3,Stanton,Fleminas,Fleminas,Unanimous,Barton,28,29,Hand,27,30,Ransom,28,29,-1,-3,-1
2020-12-11,3,Crawford,Ellis,Ellis,Unanimous,Barton,28,29,Hand,28,29,Ransom,28,29,-1,-1,-1
2020-12-10,5,Macfarlane,Velasquez,Velasquez,Unanimous,Bell,46,49,D'Amato,47,48,Miner,47,48,-3,-1,-1
2020-12-10,3,Mattos,Magomedov,Magomedov,Unanimous,Miner,26,30,Peabody,27,30,Tirelli,27,30,-4,-3,-3
2020-12-10,3,Lachinov,Nikaev,Nikaev,Unanimous,Crosby,28,29,Peabody,28,29,Rogers,28,29,-1,-1,-1
2020-12-10,5,Hadley,Shanks,Hadley,Unanimous,Barton,50,45,Hand,50,44,Ransom,50,42,5,6,8
2020-12-10,3,Maia,Martignoni,Martignoni,Unanimous,Barton,28,29,Hand,28,29,Ransom,28,29,-1,-1,-1
2020-12-10,3,Sonmez,Stephen,Stephen,Unanimous,Barton,27,30,Hand,27,30,Ransom,26,30,-3,-3,-4
2020-12-05,5,Hermansson,Vettori,Vettori,Unanimous,Cleary,46,49,D'Amato,46,49,Kamijo,45,49,-3,-3,-4
2020-12-05,3,Allan,Dolidze,Dolidze,Split,Bell,28,29,Hagen,27,30,Lee,29,28,-1,-3,1
2020-12-05,3,Collier,Villante,Collier,Unanimous,Byrd,30,27,Colón,30,27,D'Amato,30,27,3,3,3
2020-11-28,3,Porter,Parisian,Porter,Unanimous,Colón,30,26,Maness,30,27,Weeks,29,28,4,3,1
2020-11-28,3,Carlyle,Algeo,Algeo,Unanimous,Bell,27,30,D'Amato,27,30,Weeks,27,30,-3,-3,-3
2020-11-28,3,Dumont,Evans-Smith,Dumont,Unanimous,Bell,30,26,Cleary,30,26,Hagen,30,26,4,4,4
2020-11-21,5,Shevchenko,Maia,Shevchenko,Unanimous,Bell,49,46,D'Amato,49,46,Kamijo,49,46,3,3,3
2020-11-21,3,Means,Perry,Means,Unanimous,Bell,29,28,Hagen,30,27,Lee,29,28,1,3,1
2020-11-21,3,Chookagian,Calvillo,Chookagian,Unanimous,Cleary,30,27,D'Amato,30,27,Kamijo,30,27,3,3,3
2020-11-21,3,Rodriguez,Dalby,Dalby,Unanimous,Cleary,28,29,Maness,28,29,Weeks,27,30,-1,-1,-3
2020-11-21,3,Jouban,Gooden,Jouban,Unanimous,Bell,30,27,Colón,30,27,Hagen,30,27,3,3,3
2020-11-21,3,Daukaus,Stoltzfus,Daukaus,Unanimous,Bell,30,26,Kamijo,30,27,Weeks,30,27,4,3,3
2020-11-21,3,Culp,Penning,Penning,Unanimous,Champion,28,29,Divilbiss,28,29,Mildren,28,29,-1,-1,-1
2020-11-19,3,Jackson,Henderson,Jackson,Unanimous,Bell,30,27,Crosby,30,27,Peabody,30,27,3,3,3
2020-11-19,3,Lee,Davis,Davis,Unanimous,Bell,27,30,Miner,26,30,Tirelli,27,30,-3,-4,-3
2020-11-19,3,Lee,Stots,Stots,Unanimous,Bell,27,30,Crosby,27,30,Miner,27,30,-3,-3,-3
2020-11-19,3,Bessette,Kennedy,Kennedy,Unanimous,Crosby,26,30,Peabody,26,30,Tirelli,27,30,-4,-4,-3
2020-11-19,3,Lemminger,Willis,Willis,Unanimous,Bell,28,29,Miner,28,29,Murtha,28,29,-1,-1,-1
2020-11-19,3,Murray,Ferguson Jr.,Murray,Unanimous,Miner,30,27,Murtha,30,27,Tirelli,30,27,3,3,3
2020-11-14,5,dos Anjos,Felder,dos Anjos,Split,Cleary,50,45,D'Amato,50,45,Lee,47,48,5,5,-1
2020-11-14,3,Yoder,Granger,Yoder,Unanimous,Cleary,29,27,Lee,29,27,Mccarthy,30,26,2,2,4
2020-11-14,3,McKenna,Hansen,McKenna,Unanimous,Cleary,29,28,D'Amato,29,28,Lee,29,28,1,1,1
2020-11-14,3,Murata,Markos,Murata,Unanimous,Bell,30,27,D'Amato,30,27,Kamijo,30,27,3,3,3
2020-11-14,3,de Freitas Jr.,Gravely,Gravely,Split,Bell,28,29,D'Amato,29,28,Hagen,27,30,-1,1,-3
2020-11-14,3,Morono,McKee,Morono,Unanimous,Bell,30,27,Kamijo,30,27,Winter,30,27,3,3,3
2020-11-14,3,Mayes,Martinez,Mayes,Unanimous,Hagen,30,27,Kamijo,29,28,Winter,30,27,3,1,3
2020-11-14,3,Owczarz,Haba,Haba,Unanimous,Czajka,27,30,Porebski,28,29,Wojciechowski,28,29,-3,-1,-1
2020-11-14,3,Barrio,Legierski,Legierski,Majority,Czajka,28,28,Motylewski,28,29,Wojciechowski,27,29,0,-1,-2
2020-11-14,3,Torres,Coga,Torres,Split,Motylewski,28,29,Porebski,30,27,Wojciechowski,29,28,-1,3,1
2020-11-12,3,Storley,Amosov,Amosov,Split,Crosby,28,29,Tirelli,29,28,Valel,28,29,-1,1,-1
2020-11-12,5,Sanchez,Weichel,Sanchez,Unanimous,Colón,48,46,Miner,49,46,Valel,49,45,2,3,4
2020-11-12,3,Powell,Muro,Muro,Unanimous,Colón,27,30,Crosby,27,30,Peabody,28,29,-3,-3,-1
2020-11-12,3,Sootho,Lugo,Lugo,Unanimous,Bell,27,30,Colón,28,29,Crosby,27,30,-3,-1,-3
2020-11-12,3,Brennan,Salas,Brennan,Unanimous,Bell,30,26,Peabody,30,26,Tirelli,30,27,4,4,3
2020-11-07,3,Arlovski,Boser,Arlovski,Unanimous,Colón,29,28,Lee,29,28,Mccarthy,29,28,1,1,1
2020-11-07,3,Barcelos,Taha,Barcelos,Unanimous,Hagen,30,27,Lee,30,27,Mccarthy,30,27,3,3,3
2020-11-07,3,Gadelha,Xiaonan,Xiaonan,Unanimous,Bell,28,29,Cleary,28,29,D'Amato,28,29,-1,-1,-1
2020-11-05,3,Sowma,Fortune,Fortune,Unanimous,Miner,28,29,Montalvo,28,29,Tirelli,28,29,-1,-1,-1
2020-11-05,3,Vanderford,de Jesus,Vanderford,Unanimous,Miner,30,26,Montalvo,30,27,Peabody,30,27,4,3,3
2020-11-05,3,Logan,Karakhanyan,Karakhanyan,Split,Bell,28,29,Crosby,29,28,Tirelli,28,29,-1,1,-1
2020-11-05,3,Polizzi,Anglickas,Anglickas,Unanimous,Bell,27,30,Miner,27,30,Murtha,27,30,-3,-3,-3
2020-11-05,3,Harding,Miele,Harding,Unanimous,Bell,30,27,Crosby,30,27,Miner,30,27,3,3,3
2020-11-05,3,Zimmerman,Zebian,Zebian,Unanimous,Crosby,27,30,Murtha,27,30,Tirelli,28,29,-3,-3,-1
2020-11-05,3,Bates,Supino,Bates,Unanimous,Montalvo,30,25,Murtha,30,27,Tirelli,30,27,5,3,3
2020-10-31,3,Mitchell,Fili,Mitchell,Unanimous,D'Amato,30,27,Hagen,30,27,Lee,29,28,3,3,1
2020-10-31,3,Moises,Green,Moises,Unanimous,Cleary,29,28,D'Amato,29,28,Hagen,29,28,1,1,1
2020-10-31,3,Strickland,Marshman,Strickland,Unanimous,Byrd,30,27,Cleary,30,27,D'Amato,30,27,3,3,3
2020-10-29,5,Mousasi,Lima,Mousasi,Unanimous,Crosby,49,46,Tirelli,49,46,Valel,48,47,3,3,1
2020-10-29,3,Girtz,Corrales,Corrales,Split,Crosby,30,27,Peabody,27,30,Tirelli,27,30,3,-3,-3
2020-10-29,3,Gwerder,Rosta,Rosta,Unanimous,Crosby,27,30,English,27,30,Valel,27,30,-3,-3,-3
2020-10-29,3,Hager,Calton,Hager,Split,English,29,28,Rogers,28,29,Valel,29,28,1,-1,1
2020-10-29,3,Johnson,Eblen,Eblen,Unanimous,Crosby,27,30,Tirelli,27,30,Valel,28,29,-3,-3,-1
2020-10-29,3,Sanchez,Borics,Borics,Unanimous,Crosby,27,30,Rogers,28,29,Valel,27,30,-3,-1,-3
2020-10-24,3,Cannonier,Whittaker,Whittaker,Unanimous,Cleary,28,29,D'Amato,28,29,Lethaby,28,29,-1,-1,-1
2020-10-24,3,Kenney,Wood,Kenney,Unanimous,Cartlidge,29,28,Cleary,29,28,Lethaby,30,27,1,1,3
2020-10-24,3,Alvey,Jung,draw,Split,Cartlidge,28,28,Lethaby,29,28,Ransom,28,29,0,1,-1
2020-10-17,5,Jung,Ortega,Ortega,Unanimous,Cartlidge,45,50,Lethaby,45,50,Werner,45,50,-5,-5,-5
2020-10-17,3,Krause,Silva,Krause,Unanimous,Cartlidge,30,27,Ransom,30,27,Werner,30,27,3,3,3
2020-10-17,3,Martinez,Almeida,Martinez,Unanimous,Cartlidge,30,27,Ransom,30,27,Wolf,30,27,3,3,3
2020-10-17,3,Gamrot,Kutateladze,Kutateladze,Split,Lethaby,29,28,Ransom,28,29,Wolf,28,29,1,-1,-1
2020-10-17,3,Botelho,Robertson,Robertson,Unanimous,Cartlidge,27,29,Werner,27,29,Wolf,28,29,-2,-2,-1
2020-10-17,3,Phillips,Park,Park,Unanimous,Cartlidge,25,30,Lethaby,25,30,Wolf,25,30,-5,-5,-5
2020-10-17,3,Mullarkey,Ziam,Ziam,Unanimous,Cartlidge,28,29,Ransom,28,29,Werner,28,29,-1,-1,-1
2020-10-15,3,Crutchmer,Lachinov,Lachinov,Unanimous,Bell,28,29,Murtha,28,29,Peabody,28,29,-1,-1,-1
2020-10-11,3,Amirkhani,Barboza,Barboza,Unanimous,Paolillo,27,30,Ransom,26,30,Wolf,28,29,-3,-4,-1
2020-10-11,3,Rothwell,Tybura,Tybura,Unanimous,Bell,27,29,Ohlsson,27,29,Wolf,27,29,-2,-2,-2
2020-10-11,3,Topuria,Zalal,Topuria,Unanimous,Bell,29,28,Ohlsson,29,28,Paolillo,29,28,1,1,1
2020-10-11,3,Al Qaisi,Kelley,Kelley,Unanimous,Ohlsson,28,29,Ransom,27,30,Werner,28,29,-1,-3,-1
2020-10-11,3,Morales,Chikadze,Chikadze,Unanimous,Bell,27,30,Paolillo,27,30,Wolf,27,30,-3,-3,-3
2020-10-11,3,Egger,Cortez,Cortez,Unanimous,Paolillo,27,30,Ransom,27,30,Werner,27,30,-3,-3,-3
2020-10-11,3,Silva,Ulanbekov,Ulanbekov,Unanimous,Bell,28,29,Ohlsson,27,30,Wolf,28,29,-1,-3,-1
2020-10-10,3,Gustafsson,Janikowski,Janikowski,Split,Niemkowicz,28,29,Porebski,29,28,Wojciechowski,28,29,-1,1,-1
2020-10-10,3,Surdu,Romanowski,Romanowski,Unanimous,Muller,28,29,Visnjic,27,30,Wojciechowski,28,29,-1,-3,-1
2020-10-10,3,Kaszubowski,Kamieniarz,Kaszubowski,Unanimous,Porebski,30,27,Visnjic,30,24,Wojciechowski,30,27,3,6,3
2020-10-10,3,Juskiewicz,Wojcik,Wojcik,Unanimous,Muller,28,29,Niemkowicz,28,29,Visnjic,28,29,-1,-1,-1
2020-10-10,3,Kongo,Johnson,Johnson,Split,Crosby,28,29,D'Amato,28,29,Valel,29,28,-1,-1,1
2020-10-10,3,Diatta,Wooding,Diatta,Unanimous,Crosby,30,27,D'Amato,30,27,Valel,29,28,3,3,1
2020-10-10,3,Berchel,Bertaud,Bertaud,Unanimous,Crosby,28,29,D'Amato,26,30,Valel,26,30,-1,-4,-4
2020-10-10,3,N'Doye,Clarke,Clarke,Unanimous,Crosby,27,30,D'Amato,26,30,Valel,27,30,-3,-4,-3
2020-10-10,3,Houston,Page,Page,Unanimous,Crosby,27,30,D'Amato,28,29,Valel,27,30,-3,-1,-3
2020-10-03,3,Ward,Manzolo,Ward,Unanimous,Crosby,29,28,D'Amato,29,28,Valel,29,28,1,1,1
2020-10-03,3,Lehner,Kavanagh,Kavanagh,Unanimous,Crosby,27,30,D'Amato,27,30,Valel,27,30,-3,-3,-3
2020-10-03,3,Bungard,Guih,Guih,Split,Crosby,28,29,D'Amato,29,28,Valel,27,30,-1,1,-3
2020-10-03,3,Duque,Pedersoli Jr.,Duque,Unanimous,Crosby,29,27,D'Amato,30,27,Valel,30,27,2,3,3
2020-10-03,3,Fisher,Grimshaw,Fisher,Unanimous,Crosby,29,28,D'Amato,29,28,Valel,29,28,1,1,1
2020-10-03,3,Mousah,Botti,Mousah,Split,Crosby,27,30,D'Amato,29,28,Valel,29,28,-3,1,1
2020-10-03,5,Aldana,Holm,Holm,Unanimous,Bell,44,50,Tirelli,45,50,Werner,45,50,-6,-5,-5
2020-10-03,3,Felipe,De Castro,Felipe,Unanimous,Bosacki,30,27,Korchi,29,28,Ohlsson,30,27,3,1,3
2020-10-03,3,McGee,Condit,Condit,Unanimous,Ohlsson,27,30,Tirelli,27,30,Werner,27,30,-3,-3,-3
2020-10-03,3,Williams,Imavov,Imavov,Unanimous,Korchi,27,29,Ohlsson,28,29,Tirelli,27,29,-2,-1,-2
2020-10-03,3,Lookboonmee,Frey,Lookboonmee,Unanimous,Bell,30,27,Bosacki,30,27,Werner,29,28,3,3,1
2020-10-03,3,Kenney,Alateng,Kenney,Unanimous,Bosacki,30,25,Tirelli,30,27,Werner,30,26,5,3,4
2020-10-03,3,Jourdain,Culibao,draw,Split,Bell,28,28,Bosacki,28,29,Korchi,30,27,0,-1,3
2020-10-01,3,Eeckhout,Bohm,Bohm,Unanimous,Crosby,27,30,D'Amato,27,30,Valel,27,30,-3,-3,-3
2020-10-01,3,Gnusariev,Gracie,Gnusariev,Unanimous,Crosby,30,27,D'Amato,29,28,Valel,29,28,3,1,1
2020-09-27,3,Eubanks,Vieira,Vieira,Unanimous,Bell,28,29,Ohlsson,28,29,Tirelli,28,29,-1,-1,-1
2020-09-27,3,Dawodu,Tukhugov,Dawodu,Split,Korchi,29,28,Ohlsson,30,27,Tirelli,28,29,1,3,-1
2020-09-27,3,da Silva,Riddell,Riddell,Unanimous,Bell,28,29,Korchi,28,29,Werner,28,29,-1,-1,-1
2020-09-27,3,Sanchez,Matthews,Matthews,Unanimous,Ohlsson,26,30,Tirelli,26,30,Werner,26,30,-4,-4,-4
2020-09-27,3,Knight,Camur,Knight,Unanimous,Bell,29,28,Korchi,30,27,Tirelli,30,27,1,3,3
2020-09-27,3,Ibragimov,Marques,Marques,Unanimous,Korchi,28,29,Ohlsson,28,29,Tirelli,27,30,-1,-1,-3
2020-09-26,3,van Steenis,Edwards,van Steenis,Split,Crosby,28,27,D'Amato,29,28,Valel,28,29,1,1,-1
2020-09-26,3,Shipman,Penini,Shipman,Unanimous,Crosby,30,27,D'Amato,30,27,Valel,30,27,3,3,3
2020-09-26,3,Kauppinen,Fleury,Fleury,Unanimous,Crosby,27,30,D'Amato,27,30,Valel,27,30,-3,-3,-3
2020-09-26,3,Solli,Hardwick,Hardwick,Unanimous,Crosby,27,30,D'Amato,27,30,Valel,27,30,-3,-3,-3
2020-09-26,3,Pascu,Paterno,Pascu,Unanimous,Crosby,30,27,D'Amato,29,28,Valel,30,27,3,1,3
2020-09-26,3,Wanliss,Davis,Davis,Unanimous,Crosby,26,30,D'Amato,27,30,Valel,27,30,-4,-3,-3
2020-09-26,3,Mlambo,Tait,Mlambo,Unanimous,Crosby,30,27,D'Amato,29,28,Valel,30,27,3,1,3
2020-09-26,3,Hardwick,Smullen,Smullen,Unanimous,Crosby,28,29,D'Amato,28,29,Valel,28,29,-1,-1,-1
2020-09-26,3,Mearns,Lister,Lister,Unanimous,Barton,27,30,Hand,27,30,Ransom,28,29,-3,-3,-1
2020-09-26,3,Leblond,Creasey,Creasey,Unanimous,Barton,28,29,Hand,28,29,Ransom,28,29,-1,-1,-1
2020-09-26,3,Vucenic,Aimable,Vucenic,Split,Hand,29,28,Lavery,28,29,Ransom,29,28,1,-1,1
2020-09-26,3,Hill,Onwordi,Onwordi,Unanimous,Hand,28,29,Lavery,26,30,Ransom,27,29,-1,-4,-2
2020-09-24,5,Faiddine,Shanks,Shanks,Unanimous,Hand,42,50,Lavery,45,50,Ransom,41,50,-8,-5,-9
2020-09-24,3,Amarasinghe,Hignett,Amarasinghe,Unanimous,Hand,30,27,Lavery,30,27,Ransom,30,27,3,3,3
2020-09-24,3,Mulholland,Maguire,Maguire,Unanimous,Barton,27,30,Hand,25,30,Ransom,27,30,-3,-5,-3
2020-09-19,3,Holland,Stewart,Holland,Split,Colón,29,28,D'Amato,29,28,Mccarthy,28,29,1,1,-1
2020-09-19,3,Espinosa,Dvorak,Dvorak,Unanimous,Cleary,27,30,Colón,27,30,Kamijo,27,30,-3,-3,-3
2020-09-19,3,Rivera,Ewell,Ewell,Split,Bell,28,29,Hagen,28,29,Kamijo,29,28,-1,-1,1
2020-09-19,3,Price,Cerrone,draw,Majority,Colón,27,29,Lee,28,28,Mccarthy,28,28,-2,0,0
2020-09-17,3,Verzosa,Canuto,Verzosa,Split,Champion,29,28,Divilbiss,29,28,Graham,28,29,1,1,-1
2020-09-17,3,Tiburcio,Delboni,Delboni,Unanimous,Champion,27,30,Divilbiss,28,29,Graham,27,30,-3,-1,-3
2020-09-17,3,Leonardo,Tracy,Leonardo,Unanimous,Champion,29,28,Divilbiss,29,28,Graham,29,28,1,1,1
2020-09-17,3,Chieng,Peralta,Peralta,Unanimous,Champion,26,30,Divilbiss,27,30,Graham,27,30,-4,-3,-3
2020-09-12,5,Mix,Archuleta,Archuleta,Unanimous,Crosby,47,48,Miner,47,48,Tirelli,46,49,-1,-1,-3
2020-09-12,3,Madrid,Casey,Madrid,Split,Crosby,30,27,Peabody,28,29,Tirelli,29,28,3,-1,1
2020-09-12,3,Franklin,Hylton,Franklin,Unanimous,Crosby,30,27,Montalvo,30,27,Valel,30,27,3,3,3
2020-09-12,5,Waterson-Gomez,Hill,Waterson-Gomez,Split,Cleary,48,47,D'Amato,49,46,Lee,47,48,1,3,-1
2020-09-12,3,Modafferi,Lee,Modafferi,Unanimous,Cleary,29,28,D'Amato,29,28,Lee,29,28,1,1,1
2020-09-12,3,Green,Patrick,Green,Unanimous,Bell,30,27,Cleary,30,27,D'Amato,30,27,3,3,3
2020-09-12,3,Eubanks,Avila,Eubanks,Unanimous,Bell,29,27,D'Amato,29,27,Mccarthy,29,27,2,2,2
2020-09-12,3,Ivy,Barberena,Barberena,Unanimous,Hagen,28,29,Kamijo,27,30,Winter,27,30,-1,-3,-3
2020-09-11,3,Machida,Davis,Davis,Split,Crosby,29,28,Miner,28,29,Tirelli,28,29,1,-1,-1
2020-09-11,3,Zingano,Holloway,Zingano,Unanimous,Miner,30,26,Montalvo,30,26,Valel,29,27,4,4,2
2020-09-11,3,Polizzi,Carvalho,Polizzi,Unanimous,Crosby,30,27,Tirelli,30,27,Valel,30,27,3,3,3
2020-09-11,3,Bell,Smith,Smith,Unanimous,Miner,28,29,Montalvo,28,29,Valel,28,29,-1,-1,-1
2020-09-11,3,Lee,Zani,Lee,Unanimous,Crosby,29,28,Montalvo,29,28,Valel,30,27,1,1,3
2020-09-05,3,Araujo,De La Rosa,Araujo,Unanimous,Cleary,29,28,Mccarthy,30,27,Winter,30,27,1,3,3
2020-09-05,3,Azure,Smith,Azure,Unanimous,Bell,29,28,Colón,29,28,Hagen,29,28,1,1,1
2020-08-29,5,Ziolkowski,Gamrot,Gamrot,Unanimous,Bonkowski,46,49,Porebski,45,50,Wojciechowski,45,50,-3,-5,-5
2020-08-29,3,Politylo,Barbu,Politylo,Unanimous,Bonkowski,29,27,Niemkowicz,29,27,Porebski,29,27,2,2,2
2020-08-29,3,Kopera,Rajewski,Rajewski,Split,Niemkowicz,28,29,Porebski,28,29,Wojciechowski,29,28,-1,-1,1
2020-08-29,3,Stepanyan,Rajewski,Rajewski,Unanimous,Bonkowski,27,30,Porebski,25,30,Wojciechowski,27,30,-3,-5,-3
2020-08-29,3,Smith,Rakic,Rakic,Unanimous,Colón,26,30,D'Amato,27,30,Lee,27,30,-4,-3,-3
2020-08-29,3,Magny,Lawler,Magny,Unanimous,Bell,30,27,Cleary,30,27,Mccarthy,30,27,3,3,3
2020-08-29,3,Kim,Grasso,Grasso,Unanimous,Colón,27,30,D'Amato,27,30,Kamijo,27,30,-3,-3,-3
2020-08-29,3,Lamas,Algeo,Lamas,Unanimous,Bell,29,27,Hagen,29,27,Mccarthy,29,27,2,2,2
2020-08-29,3,Kasanganay,Pitolo,Kasanganay,Unanimous,D'Amato,30,27,Hagen,30,27,Mccarthy,30,27,3,3,3
2020-08-29,3,Cummings,Di Chirico,Cummings,Unanimous,Cleary,29,28,Kamijo,30,27,Lee,29,28,1,3,1
2020-08-22,5,Edgar,Munhoz,Edgar,Split,Cleary,48,47,Colón,48,47,D'Amato,46,49,1,1,-3
2020-08-22,3,Lemos,Inoue,Lemos,Unanimous,Bell,30,27,Byrd,30,27,Hagen,30,27,3,3,3
2020-08-22,3,Minus,Semelsberger,Semelsberger,Unanimous,Bell,26,30,Maness,28,29,Mccarthy,27,30,-4,-1,-3
2020-08-21,3,Budd,Miele,Budd,Unanimous,Crosby,30,26,Miner,30,27,Valel,30,27,4,3,3
2020-08-21,3,Nelson,Moldavsky,Moldavsky,Unanimous,Crosby,27,30,English,27,30,Miner,27,30,-3,-3,-3
2020-08-21,3,Outlaw,Piccolotti,Outlaw,Split,Crosby,29,28,English,28,29,Miner,29,28,1,-1,1
2020-08-21,3,Hill,Perez,Hill,Unanimous,English,29,28,Murtha,30,27,Valel,30,27,1,3,3
2020-08-21,3,de Jesus,Parubchenko,de Jesus,Unanimous,Crosby,29,28,Murtha,29,28,Valel,30,27,1,1,3
2020-08-21,3,Tokov,Gonzalez,Gonzalez,Split,Miragliotta,28,29,Murtha,27,30,Valel,29,28,-1,-3,1
2020-08-15,5,Cormier,Miocic,Miocic,Unanimous,Cleary,46,49,D'Amato,46,49,Kamijo,47,48,-3,-3,-1
2020-08-15,3,Dvalishvili,Dodson,Dvalishvili,Unanimous,Cleary,30,27,D'Amato,30,27,Winter,30,27,3,3,3
2020-08-15,3,Pichel,Miller,Pichel,Unanimous,Colón,29,27,D'Amato,29,28,Hagen,29,28,2,1,1
2020-08-15,3,Chavez,Brown,Chavez,Unanimous,Colón,29,28,D'Amato,29,28,Kamijo,29,28,1,1,1
2020-08-15,3,Yoder,Souza,Souza,Unanimous,Bell,28,29,Hagen,27,30,Kamijo,28,29,-1,-3,-1
2020-08-15,3,Kelley,Kamaka III,Kamaka III,Unanimous,Bell,28,29,Cleary,28,29,Weeks,28,29,-1,-1,-1
2020-08-08,3,Akhmedov,Weidman,Weidman,Unanimous,Bell,27,29,Colón,28,29,Mccarthy,27,29,-2,-1,-2
2020-08-08,3,Stoliarenko,Kunitskaya,Kunitskaya,Unanimous,Cleary,26,30,Colón,27,30,Mccarthy,27,30,-4,-3,-3
2020-08-08,3,Staropoli,Means,Means,Unanimous,Cleary,28,29,Kamijo,27,30,Mccarthy,28,29,-1,-3,-1
2020-08-08,3,Haqparast,Munoz,Haqparast,Unanimous,Cleary,30,27,Hagen,30,27,Lee,30,27,3,3,3
2020-08-08,3,Barrett,Zalal,Zalal,Unanimous,Bell,26,30,Mccarthy,26,30,Weeks,27,30,-4,-4,-3
2020-08-08,3,Rivera,Al Qaisi,Rivera,Split,Colón,29,28,Hagen,28,29,Kamijo,29,28,1,-1,1
2020-08-07,3,Jury,Karakhanyan,Jury,Split,Miner,29,28,Murtha,27,30,Peabody,30,27,1,-3,3
2020-08-07,3,Homasi,Millender,Homasi,Unanimous,Crosby,29,28,Miner,29,28,Tirelli,29,28,1,1,1
2020-08-07,3,Hamel,Borics,Borics,Split,Miner,28,29,Peabody,28,29,Rogers,29,28,-1,-1,1
2020-08-07,3,Agazarm,Lencioni,Lencioni,Unanimous,Crosby,28,29,Murtha,26,30,Tirelli,27,30,-1,-4,-3
2020-08-07,3,Neal,Salim,Neal,Unanimous,Murtha,30,26,Peabody,30,24,Tirelli,30,27,4,6,3
2020-08-01,3,Green,Vannata,Green,Unanimous,Bell,30,27,Cleary,30,27,Kamijo,30,26,3,3,4
2020-08-01,3,Munoz,Maness,Maness,Unanimous,Bell,27,29,Hagen,27,29,Lee,27,29,-2,-2,-2
2020-08-01,3,Cachero,Emmers,Emmers,Unanimous,Colón,27,30,Mccarthy,27,30,Weeks,27,30,-3,-3,-3
2020-08-01,3,Durden,Gutierrez,draw,Unanimous,Cleary,28,28,D'Amato,28,28,Hagen,28,28,0,0,0
2020-07-30,3,Walker,Blanchfield,Blanchfield,Unanimous,Champion,26,30,Divilbiss,26,30,Graham,26,30,-4,-4,-4
2020-07-30,3,Walker,Young,Young,Unanimous,Champion,26,30,Divilbiss,26,30,Graham,27,30,-4,-4,-3
2020-07-30,3,Guthrie,Sammons,Sammons,Split,Champion,27,30,Divilbiss,28,29,Graham,29,28,-3,-1,1
2020-07-26,5,Till,Whittaker,Whittaker,Unanimous,Cartlidge,47,48,Ohlsson,47,48,Werner,47,48,-1,-1,-1
2020-07-26,3,Nogueira,Rua,Rua,Split,Cartlidge,28,29,Collett,29,28,Lethaby,28,29,-1,1,-1
2020-07-26,3,Esparza,Rodriguez,Esparza,Split,Cartlidge,29,28,Ohlsson,28,29,Werner,30,27,1,-1,3
2020-07-26,3,Sobotta,Oliveira,Oliveira,Unanimous,Cartlidge,27,30,Ohlsson,27,30,Paolillo,27,30,-3,-3,-3
2020-07-26,3,Grundy,Evloev,Evloev,Unanimous,Bosacki,27,30,Lethaby,28,29,Paolillo,27,30,-3,-1,-3
2020-07-26,3,Correia,Kianzad,Kianzad,Unanimous,Bosacki,27,30,Lethaby,28,29,Werner,27,30,-3,-1,-3
2020-07-26,3,Stolze,Emeev,Emeev,Unanimous,Cartlidge,27,30,Ohlsson,27,30,Paolillo,28,29,-3,-3,-1
2020-07-26,3,Wood,Castaneda,Wood,Unanimous,Bosacki,30,27,Collett,30,27,Lethaby,30,27,3,3,3
2020-07-24,3,Pettis,Bandejas,Pettis,Unanimous,Colón,30,27,Peabody,30,27,Tirelli,30,27,3,3,3
2020-07-24,3,Mein,Jackson,Jackson,Unanimous,Colón,27,30,Crosby,27,30,Tirelli,27,30,-3,-3,-3
2020-07-24,3,Claxton,Wilson,Wilson,Split,Crosby,28,29,Peabody,30,27,Tirelli,27,30,-1,3,-3
2020-07-24,3,Hylton,Schaffroth,Hylton,Unanimous,Colón,29,28,Crosby,29,28,Peabody,29,28,1,1,1
2020-07-19,3,Fiziev,Diakiese,Fiziev,Unanimous,Bosacki,29,28,Lethaby,30,27,Ohlsson,29,28,1,3,1
2020-07-19,3,Askarov,Pantoja,Askarov,Unanimous,Bosacki,29,28,Lethaby,29,28,Werner,29,28,1,1,1
2020-07-19,3,Dawson,Narimani,Dawson,Unanimous,Lethaby,29,27,Ohlsson,30,26,Werner,30,27,2,4,3
2020-07-19,3,Jackson,Johns,Johns,Unanimous,Cartlidge,28,29,Ohlsson,28,29,Werner,28,29,-1,-1,-1
2020-07-19,3,Ramos,Tsarukyan,Tsarukyan,Unanimous,Bosacki,28,29,Lethaby,27,30,Werner,27,30,-1,-3,-3
2020-07-19,3,Spivak,Felipe,Spivak,Majority,Cartlidge,29,27,Ohlsson,28,28,Paolillo,29,27,2,0,2
2020-07-16,5,Ige,Kattar,Kattar,Unanimous,Cartlidge,46,49,Collett,46,49,Lethaby,47,48,-3,-3,-1
2020-07-16,3,Elliott,Benoit,Elliott,Unanimous,Cartlidge,29,28,Lethaby,29,28,Werner,29,28,1,1,1
2020-07-16,3,Stamann,Rivera,Rivera,Unanimous,Collett,28,29,Ohlsson,27,30,Paolillo,27,30,-1,-3,-3
2020-07-16,3,McCann,Santos,Santos,Unanimous,Bosacki,27,30,Lethaby,27,30,Ohlsson,27,30,-3,-3,-3
2020-07-16,3,Alhassan,Lazzez,Lazzez,Unanimous,Cartlidge,27,30,Paolillo,28,29,Werner,27,30,-3,-1,-3
2020-07-16,3,Gordon,Fishgold,Gordon,Unanimous,Bosacki,30,26,Cartlidge,30,26,Ohlsson,30,26,4,4,4
2020-07-12,5,Masvidal,Usman,Usman,Unanimous,Cartlidge,45,50,Collett,45,50,Lethaby,46,49,-5,-5,-3
2020-07-12,5,Volkanovski,Holloway,Volkanovski,Split,Collett,48,47,Lethaby,47,48,Werner,48,47,1,-1,1
2020-07-12,3,Andrade,Namajunas,Namajunas,Split,Collett,29,28,Ohlsson,28,29,Paolillo,28,29,1,-1,-1
2020-07-12,3,Zaleski dos Santos,Salikhov,Salikhov,Split,Bosacki,27,30,Lethaby,29,28,Werner,28,29,-3,1,-1
2020-07-12,3,Santos,Bogatov,Santos,Unanimous,Bosacki,29,26,Cartlidge,29,26,Werner,29,26,3,3,3
2020-07-12,3,Grishin,Tybura,Tybura,Unanimous,Collett,27,30,Lethaby,26,30,Ohlsson,27,30,-3,-4,-3
2020-07-12,3,Paiva,Zhumagulov,Paiva,Unanimous,Bosacki,29,28,Cartlidge,29,28,Paolillo,29,28,1,1,1
2020-07-12,3,Rosa,Melo,Rosa,Unanimous,Lethaby,30,26,Ohlsson,29,27,Werner,30,26,4,2,4
2020-07-11,3,Mankowski,Wrzosek,Mankowski,Unanimous,Motylewski,29,28,Niemkowicz,29,28,Porebski,29,28,1,1,1
2020-07-02,3,Ducote,Lima,Ducote,Unanimous,Berens,29,28,Divilbiss,29,28,Graham,29,28,1,1,1
2020-07-02,3,Zappitella,VanZandt,Zappitella,Split,Divilbiss,28,29,Graham,29,27,Laselva,30,27,-1,2,3
2020-07-02,3,Gallardo,Cicero,Cicero,Split,Divilbiss,28,29,Graham,28,29,Laselva,29,28,-1,-1,1
2020-07-02,3,Koren,Goodin,Goodin,Unanimous,Berens,28,29,Divilbiss,28,29,Graham,27,30,-1,-1,-3
2020-06-27,5,Poirier,Hooker,Poirier,Unanimous,Cleary,48,47,Colón,48,46,D'Amato,48,47,1,2,1
2020-06-27,3,Gall,Perry,Perry,Unanimous,Bell,28,29,D'Amato,28,29,Hagen,28,29,-1,-1,-1
2020-06-27,3,Allen,Daukaus,Allen,Unanimous,Bell,29,27,D'Amato,29,28,Hagen,30,27,2,1,3
2020-06-27,3,Griffin,Zalal,Zalal,Unanimous,Bell,28,29,Byrd,28,29,Hagen,28,29,-1,-1,-1
2020-06-20,5,Blaydes,Volkov,Blaydes,Unanimous,Colón,49,46,D'Amato,48,47,Lee,48,46,3,1,2
2020-06-20,3,Emmett,Burgos,Emmett,Unanimous,Bell,29,27,Cleary,29,28,Mccarthy,29,28,2,1,1
2020-06-20,3,Pennington,Reneau,Pennington,Unanimous,Bell,29,28,Colón,30,27,D'Amato,29,28,1,3,1
2020-06-20,3,Muhammad,Good,Muhammad,Unanimous,Cleary,29,28,Lee,29,28,Mccarthy,29,28,1,1,1
2020-06-20,3,Green,Guida,Green,Unanimous,Cleary,29,28,Lee,30,27,Mccarthy,29,28,1,3,1
2020-06-20,3,Van Buren,Torres,Torres,Unanimous,Bell,27,30,D'Amato,27,30,Winter,27,30,-3,-3,-3
2020-06-20,3,Murphy,Modafferi,Murphy,Unanimous,Cleary,30,27,Lee,29,28,Winter,30,27,3,1,3
2020-06-13,5,Eye,Calvillo,Calvillo,Unanimous,Cleary,46,49,Colón,47,48,D'Amato,46,49,-3,-1,-3
2020-06-13,3,Aguilar,Rosa,Rosa,Split,Colón,28,29,D'Amato,28,29,Hagen,29,28,-1,-1,1
2020-06-13,3,Jourdain,Fili,Fili,Split,Cleary,28,29,Colón,28,29,Mccarthy,29,28,-1,-1,1
2020-06-13,3,Espinosa,De La Rosa,Espinosa,Unanimous,Bell,30,27,D'Amato,30,26,Weeks,30,27,3,4,3
2020-06-13,3,Dvalishvili,Lopez,Dvalishvili,Unanimous,Bell,30,25,Byrd,30,26,D'Amato,30,26,5,4,4
2020-06-06,5,Spencer,Nunes,Nunes,Unanimous,Cleary,44,50,D'Amato,45,50,Lee,44,50,-6,-5,-6
2020-06-06,3,Martin,Magny,Magny,Unanimous,Colón,28,29,Hagen,27,30,Winter,27,30,-1,-3,-3
2020-06-06,3,Hooper,Caceres,Caceres,Unanimous,Bell,27,30,Cleary,27,30,Winter,27,30,-3,-3,-3
2020-06-06,3,Stamann,Kelleher,Stamann,Unanimous,Colón,30,27,Hagen,30,27,Weeks,30,27,3,3,3
2020-06-06,3,Menifield,Clark,Clark,Unanimous,Bell,28,29,Hagen,27,30,Kamijo,28,29,-1,-3,-1
2020-05-30,5,Woodley,Burns,Burns,Unanimous,Cleary,44,50,Colón,45,50,D'Amato,44,50,-6,-5,-6
2020-05-30,3,Sakai,Ivanov,Sakai,Split,Bell,27,30,Kamijo,29,28,Mccarthy,29,28,-3,1,1
2020-05-30,3,Quarantillo,Carlyle,Quarantillo,Unanimous,Colón,29,28,D'Amato,29,28,Hagen,29,28,1,1,1
2020-05-30,3,Chookagian,Shevchenko,Chookagian,Unanimous,Cleary,30,25,Colón,30,25,Hagen,30,25,5,5,5
2020-05-30,3,Green,Rodriguez,Rodriguez,Unanimous,Byrd,27,30,D'Amato,27,30,Mccarthy,27,30,-3,-3,-3
2020-05-16,3,Gadelha,Hill,Gadelha,Split,D'Amato,28,29,Lee,29,28,Tirelli,29,28,-1,1,1
2020-05-16,3,Ige,Barboza,Ige,Split,Cleary,29,28,D'Amato,29,28,Wincapaw,28,29,1,1,-1
2020-05-16,3,Anders,Jotko,Jotko,Unanimous,Cleary,28,29,Lee,28,29,Wincapaw,27,30,-1,-1,-3
2020-05-16,3,Vera,Yadong,Yadong,Unanimous,D'Amato,28,29,Reichbach,28,29,Tirelli,28,29,-1,-1,-1
2020-05-16,3,Chikadze,Rivera,Chikadze,Unanimous,Cleary,30,27,Tirelli,30,27,Wincapaw,30,26,3,3,4
2020-05-16,3,Landwehr,Elkins,Landwehr,Unanimous,D'Amato,30,27,Lee,30,27,Tirelli,29,28,3,3,1
2020-05-13,3,Saint Preux,Rothwell,Rothwell,Split,Cleary,28,29,D'Amato,29,28,Tirelli,28,29,-1,1,-1
2020-05-13,3,Simon,Borg,Simon,Split,Cleary,29,28,D'Amato,29,28,Tirelli,28,29,1,1,-1
2020-05-13,3,Lins,Arlovski,Arlovski,Unanimous,D'Amato,27,30,Reichbach,27,30,Tirelli,28,29,-3,-3,-1
2020-05-13,3,Eubanks,Moras,Eubanks,Unanimous,Lee,30,27,Luxenberg,30,26,Tirelli,30,27,3,4,3
2020-05-13,3,Morales,Benitez,Morales,Unanimous,Cleary,29,28,D'Amato,29,28,Reichbach,30,27,1,1,3
2020-05-09,3,Hardy,De Castro,Hardy,Unanimous,Cleary,30,27,Lee,30,27,Reichbach,30,27,3,3,3
2020-05-09,3,Pettis,Cerrone,Pettis,Unanimous,D'Amato,29,28,Tirelli,29,28,Wincapaw,29,28,1,1,1
2020-05-09,3,Werdum,Oleinik,Oleinik,Split,Cleary,29,28,Lee,28,29,Luxenberg,28,29,1,-1,-1
2020-05-09,3,Waterson-Gomez,Esparza,Esparza,Split,D'Amato,28,29,Reichbach,27,30,Tirelli,30,27,-1,-3,3
2020-05-09,3,Rosa,Mitchell,Mitchell,Unanimous,Cleary,24,30,Luxenberg,25,30,Wincapaw,25,30,-6,-5,-5
2020-05-09,3,Spann,Alvey,Spann,Split,D'Amato,29,28,Lee,28,29,Tirelli,29,28,1,-1,1
2020-03-21,3,Stewart,Fabinski,Fabinski,Unanimous,Brown,27,30,Cartlidge,26,30,Ransom,26,30,-3,-4,-4
2020-03-21,3,Bear,Jones,Bear,Unanimous,Brown,30,27,Hand,30,27,Ransom,30,27,3,3,3
2020-03-21,3,Goodwin,Aimable,Goodwin,Unanimous,Brown,29,28,Cartlidge,29,28,Hand,29,28,1,1,1
2020-03-21,3,Richardson,Bonner,Richardson,Unanimous,Cartlidge,30,26,Hand,30,27,Ransom,30,26,4,3,4
2020-03-21,3,Edwards,Hendin,Hendin,Unanimous,Brown,26,30,Cartlidge,25,30,Hand,27,30,-4,-5,-3
2020-03-14,3,Krylov,Walker,Krylov,Unanimous,Bell,29,28,D'Amato,29,28,Terrell,30,27,1,1,3
2020-03-14,3,Makdessi,Trinaldo,Trinaldo,Unanimous,Bell,28,29,D'Amato,27,30,Terrell,27,30,-1,-3,-3
2020-03-14,3,Formiga,Moreno,Moreno,Unanimous,Bravo,27,30,D'Amato,28,29,Pontes,28,29,-3,-1,-1
2020-03-14,3,Ribas,Markos,Ribas,Unanimous,Bell,30,26,Pontes,30,25,Terrell,30,25,4,5,5
2020-03-14,3,Zaleski dos Santos,Kunchenko,Zaleski dos Santos,Unanimous,Bravo,29,28,D'Amato,29,28,Terrell,29,28,1,1,1
2020-03-14,3,Moroz,Bueno Silva,Moroz,Unanimous,Bell,29,28,D'Amato,29,28,Terrell,29,28,1,1,1
2020-03-14,3,Silva,Dvorak,Dvorak,Unanimous,Bell,28,29,Bravo,28,29,Pontes,28,29,-1,-1,-1
2020-03-14,3,Malecki,Macedo,Malecki,Unanimous,D'Amato,29,28,Pontes,29,28,Terrell,29,28,1,1,1
2020-03-14,3,Barzola,Yahya,draw,Majority,Bravo,28,28,D'Amato,29,28,Pontes,28,28,0,1,0
2020-03-07,5,Adesanya,Romero,Adesanya,Unanimous,D'Amato,48,47,Lee,49,46,Mccarthy,48,47,1,3,1
2020-03-07,5,Jedrzejczyk,Zhang,Zhang,Split,Bell,47,48,Cleary,47,48,Colón,48,47,-1,-1,1
2020-03-07,3,Jingliang,Magny,Magny,Unanimous,Cleary,27,30,Colón,27,30,Kamijo,27,30,-3,-3,-3
2020-03-07,3,Griffin,Oliveira,Oliveira,Split,D'Amato,29,28,Hagen,28,29,Lee,28,29,1,-1,-1
2020-03-07,3,Hubbard,Madsen,Madsen,Unanimous,Colón,28,29,Hagen,28,29,Mccarthy,28,29,-1,-1,-1
2020-03-07,3,Chikadze,Emmers,Chikadze,Split,Colón,29,28,Kamijo,29,28,Weeks,28,29,1,1,-1
2020-03-07,5,Cartwright,Bilic,Cartwright,Unanimous,Cartlidge,49,46,Collett,50,45,Lethaby,48,47,3,5,1
2020-03-07,3,Fleminas,Proctor,Proctor,Unanimous,Cartlidge,26,30,Collett,26,30,Lethaby,26,30,-4,-4,-4
2020-03-07,3,Webb,Stanton,Webb,Unanimous,Cartlidge,30,26,Collett,30,26,Lethaby,30,27,4,4,3
2020-03-07,3,Magard,Gittins,Magard,Unanimous,Cartlidge,30,25,Collett,30,26,Lethaby,30,26,5,4,4
2020-03-06,5,Stoliarenko,Verzosa,Stoliarenko,Split,Champion,46,49,Divilbiss,48,46,Graham,49,46,-3,2,3
2020-02-29,3,Silva,Phillips,Phillips,Unanimous,Costello,27,30,Cuellar,27,30,D'Amato,27,30,-3,-3,-3
2020-02-29,3,Tybura,Spivak,Tybura,Unanimous,Costello,30,27,Cuellar,29,28,D'Amato,30,27,3,1,3
2020-02-29,3,Garcia,Pena,Pena,Unanimous,Costello,27,30,Cuellar,27,30,Lee,27,30,-3,-3,-3
2020-02-29,3,Naurdiev,Brady,Brady,Unanimous,Costello,28,29,Cuellar,27,30,Lee,27,29,-1,-3,-2
2020-02-22,3,Freitas,Bulaid,Bulaid,Unanimous,Cartlidge,27,30,Miner,27,30,Murtha,27,30,-3,-3,-3
2020-02-22,3,McCourt,Ruis,McCourt,Unanimous,Cartlidge,29,28,Crosby,30,27,Miner,29,28,1,3,1
2020-02-22,3,Chalmers,Clem,Clem,Unanimous,Cartlidge,27,30,Crosby,27,30,Miner,26,30,-3,-3,-4
2020-02-22,3,Furtado,Crosbie,Crosbie,Split,Cartlidge,29,28,Crosby,28,29,Miner,28,29,1,-1,-1
2020-02-22,3,Kallionidou,Rawlings,Rawlings,Unanimous,Cartlidge,28,29,Crosby,27,30,Murtha,27,30,-1,-3,-3
2020-02-22,3,McCormack,Penco,McCormack,Unanimous,Cartlidge,29,28,Miner,30,27,Murtha,30,27,1,3,3
2020-02-22,3,Dias,Smullen,Dias,Split,Cartlidge,29,28,Crosby,28,29,Miner,29,28,1,-1,1
2020-02-22,3,Clarke,Faulding,Clarke,Unanimous,Crosby,30,26,Miragliotta,30,26,Roberts,29,27,4,4,2
2020-02-22,3,Blanita,Adjoudj,Blanita,Split,Anderson,28,29,Cartlidge,29,28,Miragliotta,29,28,-1,1,1
2020-02-22,5,Felder,Hooker,Hooker,Split,Foley,48,47,Hughes,47,48,Lethaby,47,48,1,-1,-1
2020-02-22,3,Kowalkiewicz,Xiaonan,Xiaonan,Unanimous,Hill,26,30,Hughes,26,30,Lethaby,26,30,-4,-4,-4
2020-02-22,3,Riddell,Mustafaev,Riddell,Split,Booth,29,28,Foley,28,29,Hill,29,28,1,-1,1
2020-02-22,3,Matthews,Meek,Matthews,Unanimous,Booth,29,28,Foley,29,28,Rodgers,29,28,1,1,1
2020-02-22,3,Kara-France,Nam,Kara-France,Unanimous,Foley,30,27,Gerard,30,27,Taia,30,27,3,3,3
2020-02-22,3,Lookboonmee,Hill,Hill,Unanimous,Booth,28,29,Lethaby,27,30,Rodgers,28,29,-1,-3,-1
2020-02-21,3,McKenzie,Gonzalez,Gonzalez,Split,Cleary,27,30,Turnage,29,28,Valel,27,30,-3,1,-3
2020-02-21,3,Benjilany,Croom,Croom,Split,Cleary,28,29,D'Amato,28,29,Lee,29,28,-1,-1,1
2020-02-21,3,Lencioni,Mukhidinov,Lencioni,Split,D'Amato,29,28,Lee,29,28,Valel,27,30,1,1,-3
2020-02-21,3,Ruth,Amosov,Amosov,Unanimous,D'Amato,28,29,Lee,28,29,Valel,28,29,-1,-1,-1
2020-02-21,3,Girtz,Jury,Jury,Unanimous,Cleary,28,29,D'Amato,28,29,Lee,28,29,-1,-1,-1
2020-02-21,3,Ayala,Moldavsky,Moldavsky,Unanimous,Cleary,24,30,D'Amato,25,30,Valel,24,30,-6,-5,-6
2020-02-21,3,Zani,Hill,Hill,Unanimous,Cleary,28,29,Lee,28,29,Turnage,27,30,-1,-1,-3
2020-02-21,3,Bolanos,Hatley Jr.,Hatley Jr.,Split,Cleary,28,29,D'Amato,28,29,Lee,29,28,-1,-1,1
2020-02-21,3,Britton,Varga,Britton,Split,D'Amato,29,28,Turnage,28,29,Valel,29,28,1,-1,1
2020-02-21,3,Bunch,Lee,Lee,Unanimous,Cleary,26,30,Turnage,28,29,Valel,27,29,-4,-1,-2
2020-02-21,3,Hutch,Edwards,Edwards,Unanimous,Cleary,26,30,Lee,26,30,Turnage,25,30,-4,-4,-5
2020-02-15,3,Romero Borella,De La Rosa,De La Rosa,Unanimous,Cleary,27,30,D'Amato,27,30,Lopez,27,30,-3,-3,-3
2020-02-15,3,Borg,Bontorin,Borg,Unanimous,Cleary,30,25,Ortiz,30,27,Trowbridge,30,27,5,3,3
2020-02-15,3,Medeiros,Vannata,Vannata,Unanimous,Cleary,27,30,Lopez,27,30,Weeks,27,30,-3,-3,-3
2020-02-15,3,Holtzman,Miller,Holtzman,Unanimous,D'Amato,30,27,Lopez,29,28,Weeks,29,28,3,1,1
2020-02-15,3,Clark,Townsend,Clark,Unanimous,Ortiz,30,27,Sanchez,30,26,Trowbridge,30,26,3,4,4
2020-02-15,3,Dvalishvili,Kenney,Dvalishvili,Unanimous,Cleary,29,28,D'Amato,30,27,Lopez,30,25,1,3,5
2020-02-15,3,Chiasson,Young,Chiasson,Unanimous,Sanchez,30,26,Trowbridge,30,26,Weeks,30,26,4,4,4
2020-02-08,5,Jones,Reyes,Jones,Unanimous,Lee,48,47,Rosales,48,47,Soliz,49,46,1,1,3
2020-02-08,3,Bektic,Ige,Ige,Split,Ferraro,28,29,Patlán,29,28,Rosales,28,29,-1,1,-1
2020-02-08,3,Latifi,Lewis,Lewis,Unanimous,Alexander,28,29,Dealejandro,28,29,Lee,28,29,-1,-1,-1
2020-02-08,3,Krause,Giles,Giles,Split,Ferraro,28,29,Patlán,29,28,Soliz,28,29,-1,1,-1
2020-02-08,3,Murphy,Lee,Murphy,Split,Dealejandro,30,27,Lee,28,29,Patlán,29,28,3,-1,1
2020-02-08,3,Martinez,Ewell,Ewell,Split,Dealejandro,28,29,Ferraro,29,28,Soliz,27,30,-1,1,-3
2020-02-08,3,Lingo,Zalal,Zalal,Unanimous,Alexander,27,30,Lee,27,30,Williams,27,30,-3,-3,-3
2020-02-07,5,Frey,Cummins,Frey,Unanimous,Champion,48,47,Divilbiss,48,47,Graham,48,47,1,1,1
2020-02-07,3,Gonzalez,Maverick,Maverick,Unanimous,Champion,27,30,Divilbiss,27,30,Graham,26,30,-3,-3,-4
2020-02-07,3,Zappitella,D'Angelo,Zappitella,Unanimous,Champion,30,27,Divilbiss,29,28,Graham,30,27,3,1,3
2020-02-07,3,DeCoursey,Mihalec,DeCoursey,Unanimous,Champion,29,28,Divilbiss,29,28,Graham,30,27,1,1,3
2020-02-07,3,Pettigrew,Franco,Franco,Unanimous,Champion,27,30,Divilbiss,27,30,Graham,26,30,-3,-3,-4
2020-01-25,3,dos Anjos,Chiesa,Chiesa,Unanimous,Colón,28,29,Lee,28,29,Weeks,27,30,-1,-1,-3
2020-01-25,3,Stosic,Hill,Hill,Unanimous,Lee,28,29,Sorber,28,29,Weeks,28,29,-1,-1,-1
2020-01-25,3,Lewis,Townsend,Lewis,Unanimous,Colón,30,27,D'Amato,30,27,Weeks,30,27,3,3,3
2020-01-25,3,Allen,Lentz,Allen,Unanimous,Cleary,29,28,Lee,30,27,Sorber,29,28,1,3,1
2020-01-25,3,Kish,Pudilova,Kish,Unanimous,Colón,30,27,Ebert,30,27,Weeks,30,27,3,3,3
2020-01-25,3,Jackson,Colares,Jackson,Unanimous,Cleary,30,26,D'Amato,30,25,Sorber,30,26,4,5,4
2020-01-25,3,McMann,Lansberg,McMann,Unanimous,Colón,30,25,Ebert,30,27,Lee,30,26,5,3,4
2020-01-25,3,Bartovich,Conner,Bartovich,Unanimous,Landless,29,28,Maness,29,28,Mccarthy,29,28,1,1,1
2020-01-25,3,Corrales,Archuleta,Archuleta,Unanimous,Bell,28,29,Cobian,28,29,Mccarthy,28,29,-1,-1,-1
2020-01-25,3,Jones,Bender,Jones,Unanimous,Bell,30,27,Crail,29,27,Denkin,30,26,3,2,4
2020-01-25,3,Murrietta,Millender,Millender,Unanimous,Cobian,26,30,Crail,27,30,Landless,26,30,-4,-3,-4
2020-01-25,3,Taylor,Avila,Taylor,Majority,Crail,29,28,Landless,28,28,Mccarthy,29,28,1,0,1
2020-01-25,3,Pacheco,Jacob,Jacob,Unanimous,Crail,27,30,Denkin,27,30,Landless,26,30,-3,-3,-4
2020-01-18,3,Holm,Pennington,Holm,Unanimous,Bell,29,28,Colón,30,27,Mccarthy,30,27,1,3,3
2020-01-18,3,Barber,Modafferi,Modafferi,Unanimous,Colón,27,30,D'Amato,27,30,Hagen,26,30,-3,-3,-4
2020-01-18,3,Fili,Yusuff,Yusuff,Unanimous,Byrd,28,29,Cleary,28,29,Lee,28,29,-1,-1,-1
2020-01-18,3,Elliott,Askarov,Askarov,Unanimous,Bell,28,29,D'Amato,27,30,Hagen,27,30,-1,-3,-3
2020-01-18,3,Ledet,Camur,Camur,Unanimous,Cleary,28,29,Mccarthy,27,30,Weeks,27,30,-1,-3,-3
2020-01-18,3,Mazo,Aldrich,Mazo,Split,Byrd,29,28,Kamijo,29,28,Lee,28,29,1,1,-1
2019-12-29,3,Nakamura,Larkin,Larkin,Unanimous,Colón,27,30,D'Amato,26,30,Peabody,26,30,-3,-4,-4
2019-12-21,3,Oezdemir,Rakic,Oezdemir,Split,Collett,29,28,Dimitriou,29,28,Field,28,29,1,1,-1
2019-12-21,3,Park,Barriault,Park,Unanimous,Collett,29,28,Dimitriou,29,28,Field,30,27,1,1,3
2019-12-21,3,Pingyuan,Kang,Kang,Split,Cartlidge,28,29,Field,29,28,Sutherland,27,30,-1,1,-3
2019-12-21,3,Boser,Gane,Gane,Unanimous,Collett,26,30,Dimitriou,26,30,Field,26,30,-4,-4,-4
2019-12-21,3,Choi,Mokhtarian,Choi,Unanimous,Cartlidge,29,26,Field,29,26,Sutherland,29,25,3,3,4
2019-12-21,3,Ma,Morales,Morales,Unanimous,Collett,27,30,Dimitriou,26,30,Sutherland,28,29,-3,-4,-1
2019-12-21,3,Barcelos,Nurmagomedov,Barcelos,Unanimous,Cartlidge,29,28,Field,29,28,Sutherland,30,27,1,1,3
2019-12-21,3,Alateng,Benoit,Alateng,Split,Cartlidge,29,28,Dimitriou,29,28,Field,28,29,1,1,-1
2019-12-21,5,Macfarlane,Jackson,Macfarlane,Unanimous,Bell,50,45,D'Amato,50,44,Lee,50,44,5,6,6
2019-12-21,3,Kunimoto,Jackson,Jackson,Unanimous,Bell,27,30,D'Amato,27,30,Lee,27,30,-3,-3,-3
2019-12-21,3,Stots,Leialoha,Stots,Unanimous,Bell,30,27,Lee,29,28,Takao,29,28,3,1,1
2019-12-21,3,Higa,Kamaka III,Kamaka III,Unanimous,Lee,27,30,Onzuka,27,30,Takao,27,30,-3,-3,-3
2019-12-20,3,Arteaga,Lara,Lara,Unanimous,Bell,26,30,D'Amato,27,30,Trigg,26,30,-4,-3,-4
2019-12-20,3,Claxton,Akeo,Claxton,Unanimous,Antoque,30,27,Lee,30,27,Trigg,30,27,3,3,3
2019-12-14,5,Volkanovski,Holloway,Volkanovski,Unanimous,Bell,48,47,Kamijo,50,45,Lee,48,47,1,5,1
2019-12-14,5,Nunes,de Randamie,Nunes,Unanimous,D'Amato,49,44,Hagen,49,46,Mccarthy,49,45,5,3,4
2019-12-14,3,Aldo,Moraes,Moraes,Split,Bell,29,28,Colón,28,29,Smith,28,29,1,-1,-1
2019-12-14,3,Akhmedov,Heinisch,Akhmedov,Unanimous,Bell,29,28,D'Amato,29,28,Mccarthy,29,28,1,1,1
2019-12-14,3,Kara-France,Moreno,Moreno,Unanimous,Kamijo,28,29,Lee,28,29,Smith,27,30,-1,-1,-3
2019-12-14,3,Eye,Araujo,Eye,Unanimous,Bell,29,28,Cleary,29,28,Hagen,29,28,1,1,1
2019-12-07,3,Simon,Font,Font,Unanimous,Braslow,27,30,Colflesh,28,29,D'Amato,28,29,-3,-1,-1
2019-12-07,3,Wiman,Solecki,Solecki,Unanimous,Braslow,26,30,D'Amato,26,30,Rados,27,30,-4,-4,-3
2019-12-07,3,Askham,Khalidov,Askham,Unanimous,Kloc,29,28,Paolillo,30,27,Werner,29,28,1,3,1
2019-12-07,5,Buchinger,Parnasse,Parnasse,Unanimous,Lethaby,44,50,Porebski,45,50,Wojciechowski,45,50,-6,-5,-5
2019-12-07,3,Rodriguez,Calvillo,draw,Majority,Braslow,28,28,D'Amato,28,28,Lee,29,28,0,0,1
2019-12-07,3,Stamann,Yadong,draw,Majority,Braslow,28,28,D'Amato,29,27,Rados,28,28,0,2,0
2019-11-23,3,Shipman,Edwards,Edwards,Split,Cartlidge,27,30,D'Amato,28,29,Tirelli,29,28,-3,-1,1
2019-11-23,3,Bak,Brazier,Bak,Unanimous,Cartlidge,29,28,D'Amato,30,27,Peabody,30,27,1,3,3
2019-11-23,3,Wilde,Leary,Wilde,Unanimous,Cartlidge,29,28,English,29,28,Tirelli,29,28,1,1,1
2019-11-23,3,Penini,Ward,Penini,Unanimous,Cartlidge,30,27,D'Amato,30,27,Tirelli,29,28,3,3,1
2019-11-23,3,Davis,Botti,Davis,Unanimous,Cartlidge,29,28,English,30,27,Tirelli,30,27,1,3,3
2019-11-23,3,Fryer,Tokkos,Fryer,Unanimous,Montalvo,30,27,Peabody,30,27,Tirelli,30,27,3,3,3
2019-11-23,3,Mearns,Petley,Petley,Unanimous,English,27,30,Peabody,27,30,Tirelli,27,30,-3,-3,-3
2019-11-23,3,Hardwick,Rose,Hardwick,Majority,Cartlidge,28,28,Montalvo,29,28,Roberts,29,28,0,1,1
2019-11-22,3,Aimable,Burnell,Burnell,Unanimous,Cartlidge,26,30,Collett,26,30,Lethaby,26,30,-4,-4,-4
2019-11-22,3,Golding,Sonmez,Sonmez,Unanimous,Cartlidge,28,29,Collett,28,29,Lethaby,28,29,-1,-1,-1
2019-11-22,3,Gittins,Amarasinghe,Gittins,Unanimous,Cartlidge,29,28,Collett,29,28,Lethaby,29,28,1,1,1
2019-11-22,3,Onwordi,Davies,Onwordi,Unanimous,Cartlidge,30,25,Collett,30,25,Lethaby,30,24,5,5,6
2019-11-22,3,Barton,Hendin,Hendin,Unanimous,Cartlidge,28,29,Collett,28,29,Lethaby,28,29,-1,-1,-1
2019-11-16,5,Blachowicz,Souza,Blachowicz,Split,D'Amato,48,47,Lee,48,47,Pontes,47,48,1,1,-1
2019-11-16,3,Arroyo,Muniz,Muniz,Unanimous,D'Amato,27,30,Lee,27,30,Vilhena,27,30,-3,-3,-3
2019-11-16,3,Perez,Turman,Turman,Unanimous,Bravo,27,30,Lee,27,30,Vilhena,27,30,-3,-3,-3
2019-11-16,3,Trinaldo,Green,Trinaldo,Unanimous,Bravo,29,28,D'Amato,30,27,Vilhena,29,28,1,3,1
2019-11-16,3,Barão,Silva de Andrade,Silva de Andrade,Unanimous,Bravo,26,30,D'Amato,27,30,Vilhena,27,30,-4,-3,-3
2019-11-16,3,de Padua,Lipski,Lipski,Unanimous,Bravo,27,29,Lee,26,30,Pontes,26,30,-2,-4,-4
2019-11-16,3,Cortez,Melo,Cortez,Unanimous,D'Amato,30,27,Pontes,29,27,Vilhena,30,27,3,2,3
2019-11-16,3,Craig,Rua,draw,Split,Bravo,28,28,D'Amato,28,29,Vilhena,29,28,0,-1,1
2019-11-14,3,Huerta,Outlaw,Outlaw,Unanimous,Bell,27,30,Colón,27,30,Miner,28,29,-3,-3,-1
2019-11-14,3,Bozinyan,Vanderford,Vanderford,Unanimous,Beltran,28,29,Colón,28,29,Miner,28,29,-1,-1,-1
2019-11-14,3,Bring,Danylyuk,Bring,Unanimous,Bell,29,28,Colón,30,27,Miner,30,26,1,3,4
2019-11-14,3,Dulger,Leibel,Dulger,Unanimous,Anderson,30,27,Bell,29,28,Colón,30,27,3,1,3
2019-11-14,3,Aronov,Hleihil,Aronov,Unanimous,Beltran,30,26,Colón,30,26,Herzog,28,27,4,4,1
2019-11-14,3,Voldman,Rosales,Voldman,Split,Beltran,28,29,Colón,29,28,Miner,30,27,-1,1,3
2019-11-14,3,Tratner,Mamadov,draw,Split,Anderson,28,29,Bell,28,27,Miner,28,28,-1,1,0
2019-11-09,3,Magomedsharipov,Kattar,Magomedsharipov,Unanimous,Collett,29,28,Lethaby,29,28,Sutherland,29,28,1,1,1
2019-11-09,3,Hardy,Volkov,Volkov,Unanimous,Bosacki,27,30,Hughes,27,30,Werner,27,30,-3,-3,-3
2019-11-09,3,Ibragimov,Herman,Herman,Unanimous,Bosacki,27,30,Hughes,28,29,Magomedov,27,30,-3,-1,-3
2019-11-09,3,Emeev,Martin,Martin,Unanimous,Collett,27,30,Lethaby,28,29,Werner,28,29,-3,-1,-1
2019-11-09,3,Abreu,Gamzatov,Gamzatov,Split,Bosacki,29,28,Hughes,28,29,Sutherland,28,29,1,-1,-1
2019-11-09,3,Khabilov,Khandozhko,Khabilov,Unanimous,Bosacki,30,27,Magomedov,29,28,Sutherland,29,28,3,1,1
2019-11-09,3,Yakovlev,Roberts,Roberts,Unanimous,Bosacki,28,29,Hughes,28,29,Werner,28,29,-1,-1,-1
2019-11-09,3,Clark,Kianzad,Kianzad,Unanimous,Collett,27,30,Lethaby,27,30,Magomedov,27,30,-3,-3,-3
2019-11-09,3,Grant,Popov,Grant,Split,Bosacki,29,28,Hughes,29,28,Sutherland,28,29,1,1,-1
2019-11-09,3,Nolan,Mitchell,Mitchell,Unanimous,Cartlidge,27,30,Oglesby,28,29,Ransom,27,30,-3,-1,-3
2019-11-09,3,Maguire,Akpan,Akpan,Unanimous,Cartlidge,27,30,Oglesby,28,29,Ransom,27,30,-3,-1,-3
2019-11-09,3,Jazbutis,McAleenan,McAleenan,Unanimous,Cartlidge,26,30,Oglesby,26,30,Ransom,26,30,-4,-4,-4
2019-11-09,3,Wojtyna,Chabaan,Chabaan,Unanimous,Cartlidge,27,30,Oglesby,28,29,Ransom,27,30,-3,-1,-3
2019-11-09,5,Stasiak,Racic,Racic,Majority,Cacic,47,48,Wojciechowski,46,48,Wolf,47,47,-1,-2,0
2019-11-09,3,Torres,Pejic,Torres,Unanimous,Bonkowski,29,28,Porebski,30,27,Wojciechowski,30,27,1,3,3
2019-11-09,3,Janicic,Szymanski,Szymanski,Unanimous,Bonkowski,27,29,Cacic,27,29,Wojciechowski,27,29,-2,-2,-2
2019-11-09,3,Truscek,Kaszubowski,Kaszubowski,Split,Porebski,28,29,Visnjic,28,29,Wojciechowski,29,28,-1,-1,1
2019-11-09,3,Przybysz,Krusic,Przybysz,Unanimous,Niemkowicz,30,26,Visnjic,30,27,Wolf,29,28,4,3,1
2019-11-08,3,Salter,van Steenis,Salter,Unanimous,Cleary,29,28,D'Amato,29,28,Lee,29,28,1,1,1
2019-11-08,3,Blencowe,Smith,Blencowe,Unanimous,D'Amato,30,27,Lee,30,27,Therien,30,27,3,3,3
2019-11-08,3,Fortune,Campbell,Fortune,Split,D'Amato,29,28,Lee,29,28,Therien,28,29,1,1,-1
2019-11-08,3,Young,Anglickas,Anglickas,Unanimous,Cleary,27,30,D'Amato,27,30,Lee,27,30,-3,-3,-3
2019-11-08,3,Gidron,Crutchmer,Crutchmer,Unanimous,D'Amato,27,30,Lee,27,30,Therien,27,30,-3,-3,-3
2019-11-08,3,Neal,Lugo,Neal,Unanimous,Cleary,30,26,Lee,30,26,Therien,29,28,4,4,1
2019-11-02,3,Till,Gastelum,Till,Split,Colón,29,28,Lee,30,27,Tirelli,27,30,1,3,-3
2019-11-02,3,Thompson,Luque,Thompson,Unanimous,Cleary,30,26,Crosby,30,26,D'Amato,29,27,4,4,2
2019-11-02,3,Lewis,Ivanov,Lewis,Split,Colón,28,29,Lee,29,28,Tirelli,30,27,-1,1,3
2019-11-02,3,Maia,Chookagian,Chookagian,Unanimous,Cleary,28,29,Colón,28,29,D'Amato,28,29,-1,-1,-1
2019-11-02,3,Dawodu,Arce,Dawodu,Split,Cleary,29,28,Colón,29,28,Lee,28,29,1,1,-1
2019-11-01,5,Murata,Ducote,Murata,Split,Champion,48,47,Divilbiss,47,48,Graham,49,46,1,-1,3
2019-11-01,3,Porto,Rodriguez,Porto,Unanimous,Champion,29,28,Divilbiss,29,28,Graham,29,28,1,1,1
2019-11-01,3,Arceo,Martin,Martin,Unanimous,Champion,26,30,Divilbiss,26,30,Graham,27,30,-4,-4,-3
2019-11-01,3,Suotama,Young,Young,Unanimous,Champion,27,29,Divilbiss,27,28,Graham,26,28,-2,-1,-2
2019-11-01,3,Kenneson,Verzosa,Verzosa,Unanimous,Champion,28,29,Divilbiss,28,29,Graham,28,29,-1,-1,-1
2019-11-01,3,Rincon,Norton,Norton,Unanimous,Champion,26,30,Divilbiss,26,30,Graham,26,30,-4,-4,-4
2019-11-01,3,Tennant,deJesus,Tennant,Unanimous,Champion,29,28,Divilbiss,29,28,Graham,29,28,1,1,1
2019-10-26,3,Bouland,Miah,Miah,Unanimous,Brown,27,30,Lethaby,28,29,Ransom,28,29,-3,-1,-1
2019-10-26,3,Alekozai,Goodwin,Goodwin,Unanimous,Brown,27,30,Lethaby,27,30,Ransom,26,30,-3,-3,-4
2019-10-26,3,Deh,Vucenic,Vucenic,Unanimous,Brown,27,30,Lethaby,27,30,Ransom,27,30,-3,-3,-3
2019-10-26,3,Hardwick,Fleminas,Fleminas,Unanimous,Brown,27,30,Lethaby,27,30,Ransom,27,30,-3,-3,-3
2019-10-26,3,Ebanks,Smith,Smith,Unanimous,Brown,25,30,Lethaby,26,30,Ransom,25,30,-5,-4,-5
2019-10-26,5,Lima,MacDonald,Lima,Unanimous,Cartlidge,50,45,Colón,50,45,D'Amato,49,46,5,5,3
2019-10-26,3,Muro,Newell,Muro,Split,Cartlidge,29,28,D'Amato,29,28,Tirelli,27,29,1,1,-2
2019-10-26,3,Lopez,Cormier,Lopez,Unanimous,Cartlidge,29,28,Sanidad,30,27,Tirelli,30,27,1,3,3
2019-10-26,3,Douma,Lugo,Lugo,Unanimous,Cartlidge,26,30,Peabody,27,30,Sanidad,27,30,-4,-3,-3
2019-10-26,3,Johnson,Ray,Ray,Majority,Field,28,28,Foley,28,29,Harasim,28,29,0,-1,-1
2019-10-26,3,Staropoli,Salikhov,Salikhov,Unanimous,Field,26,30,Hughes,26,30,Kobayashi,28,29,-4,-4,-1
2019-10-26,3,Markos,Yoder,Markos,Split,Collett,29,28,Field,28,29,Hughes,29,28,1,-1,1
2019-10-26,3,Fiziev,White,Fiziev,Unanimous,Foley,29,28,Harasim,30,27,Kobayashi,30,27,1,3,3
2019-10-26,3,Evloev,Barzola,Evloev,Unanimous,Collett,29,28,Harasim,30,27,Hughes,29,28,1,3,1
2019-10-26,3,Albu,Lookboonmee,Lookboonmee,Split,Collett,27,30,Foley,29,28,Harasim,27,30,-3,1,-3
2019-10-26,3,Hughes,Pessoa,Pessoa,Unanimous,Field,27,30,Hughes,27,30,Kobayashi,27,30,-3,-3,-3
2019-10-25,3,Nelson,Mir,Mir,Unanimous,Cartlidge,28,29,D'Amato,28,29,Peabody,27,30,-1,-1,-3
2019-10-25,3,Ruth,Jackson,Ruth,Split,Cartlidge,28,29,Crosby,29,28,Tirelli,29,28,-1,1,1
2019-10-25,3,Haly,Nkuta,Nkuta,Unanimous,Cartlidge,26,30,English,27,30,Peabody,26,30,-4,-3,-4
2019-10-25,3,Miele,Nogueira,Miele,Split,Cartlidge,30,27,Crosby,28,29,English,30,27,3,-1,3
2019-10-25,3,Pimenta Borges,Caron,Caron,Unanimous,Cartlidge,28,29,English,28,29,Sanidad,28,29,-1,-1,-1
2019-10-25,3,Manley,Oliveira,Manley,Unanimous,Crosby,30,27,Murtha,29,28,Tirelli,29,28,3,1,1
2019-10-18,3,Stephens,Rodriguez,Rodriguez,Unanimous,Ginsberg,28,29,Tirelli,28,29,Varela,28,29,-1,-1,-1
2019-10-18,3,Winn,Stewart,Stewart,Split,Colón,28,29,Mahmood,28,29,Tirelli,29,28,-1,-1,1
2019-10-18,3,Belbita,McCann,McCann,Unanimous,Ginsberg,25,30,Lee,25,30,Tirelli,25,30,-5,-5,-5
2019-10-18,3,Bochniak,Woodson,Woodson,Unanimous,D'Amato,27,30,Mahmood,27,30,Varela,26,30,-3,-3,-4
2019-10-18,3,Brady,McGee,Brady,Unanimous,Lee,29,28,Tirelli,30,27,Varela,30,27,1,3,3
2019-10-18,3,Boser,Spitz,Boser,Unanimous,Colón,30,27,Mahmood,30,27,Tirelli,30,27,3,3,3
2019-10-12,3,Paterno,Reece,Paterno,Unanimous,Crosby,29,27,D'Amato,29,27,Valel,30,27,2,2,3
2019-10-12,3,Macedo,Mousah,Macedo,Split,Crosby,29,28,D'Amato,27,30,Miner,29,28,1,-3,1
2019-10-12,3,Zubco,Gerges,Zubco,Unanimous,Cartlidge,29,28,Crosby,29,28,Miner,29,28,1,1,1
2019-10-12,3,Sidelnikov,Barros,Sidelnikov,Unanimous,Cartlidge,29,28,D'Amato,29,28,Miner,30,27,1,1,3
2019-10-12,3,Fusi,Pugliesi,Pugliesi,Unanimous,Crosby,27,30,D'Amato,27,30,Hatley,27,30,-3,-3,-3
2019-10-12,5,Waterson-Gomez,Jedrzejczyk,Jedrzejczyk,Unanimous,Cleary,45,50,Lee,45,50,Tirelli,46,49,-5,-5,-3
2019-10-12,3,Swanson,Gracie,Swanson,Unanimous,Cleary,30,27,Tirelli,30,27,Weeks,30,27,3,3,3
2019-10-12,3,Ribas,Dern,Ribas,Unanimous,Olney,30,27,Weeks,30,27,Wincapaw,30,27,3,3,3
2019-10-12,3,Frevola,Pena,Frevola,Split,Lee,28,29,Torres,29,28,Weeks,29,28,-1,1,1
2019-10-12,3,Meerschaert,Anders,Anders,Split,Cleary,29,28,Olney,28,29,Weeks,28,29,1,-1,-1
2019-10-12,3,Morono,Griffin,Morono,Unanimous,Olney,29,28,Tirelli,29,27,Weeks,29,27,1,2,2
2019-10-12,3,Sanchez,Vettori,Vettori,Unanimous,Cleary,27,30,Tirelli,27,30,Torres,27,30,-3,-3,-3
2019-10-12,3,Aldrich,Mueller,Aldrich,Unanimous,Lee,29,28,Olney,29,28,Weeks,30,27,1,1,3
2019-10-12,3,Mantykivi,Jones,Jones,Unanimous,Collett,26,30,Lethaby,25,30,Ransom,25,30,-4,-5,-5
2019-10-06,3,Iaquinta,Hooker,Hooker,Unanimous,Gerard,27,30,Harriman,27,30,Lethaby,26,30,-3,-3,-4
2019-10-06,3,Jumeau,Lima,Lima,Split,Harriman,29,28,Keech,28,29,Shen,28,29,1,-1,-1
2019-10-06,3,Akman,Matthews,Matthews,Unanimous,Cartlidge,27,30,Keech,27,30,Shen,27,30,-3,-3,-3
2019-10-06,3,Potter,Pitolo,Potter,Unanimous,Dimitriou,29,28,Gerard,29,28,Lethaby,29,28,1,1,1
2019-10-06,3,Mullarkey,Riddell,Riddell,Unanimous,Cartlidge,26,30,Keech,26,30,Shen,27,29,-4,-4,-2
2019-10-04,3,Gonzalez,Walker,Gonzalez,Unanimous,Champion,30,27,Divilbiss,30,27,Graham,30,27,3,3,3
2019-10-04,3,Messer-Belenchia,Mihalec,Mihalec,Unanimous,Champion,28,29,Divilbiss,27,30,Graham,27,30,-1,-3,-3
2019-10-04,3,Larkin,Koreshkov,Larkin,Split,Bell,29,28,Cobian,29,28,Mccarthy,28,29,1,1,-1
2019-10-04,3,Polk,Taylor Melendez,Taylor Melendez,Unanimous,Bell,27,30,Denkin,27,30,Mccarthy,27,30,-3,-3,-3
2019-10-04,3,Mukhidinov,Altamimi,Mukhidinov,Unanimous,Cobian,30,27,Mccarthy,30,26,Paulson,29,27,3,4,2
2019-09-28,3,Jazbutis,Ventre,Ventre,Unanimous,Cartlidge,26,30,Lethaby,28,29,Ransom,27,30,-4,-1,-3
2019-09-28,3,Proctor,Santalahti,Proctor,Unanimous,Cartlidge,29,28,Collett,30,27,Lethaby,29,28,1,3,1
2019-09-28,3,McCormack,Rivarola,McCormack,Unanimous,Colón,30,27,Crosby,29,28,Tirelli,29,28,3,1,1
2019-09-28,3,Henderson,Jury,Henderson,Unanimous,Crosby,30,27,Miner,30,27,Tirelli,30,27,3,3,3
2019-09-28,3,Pereira,Crosbie,Crosbie,Unanimous,Colón,28,29,Crosby,27,30,Miner,28,29,-1,-3,-1
2019-09-28,3,Fleury,Novenyi Jr.,Novenyi Jr.,Unanimous,Colón,26,30,Crosby,27,30,Tirelli,26,30,-4,-3,-4
2019-09-28,3,Wooding,Mlambo,Mlambo,Unanimous,Colón,28,29,Crosby,27,30,Roberts,27,30,-1,-3,-3
2019-09-28,3,Pietila,Roddy,Roddy,Unanimous,Crosby,27,29,Roberts,27,29,Tirelli,27,29,-2,-2,-2
2019-09-28,3,Chadwick,Moore,Moore,Split,Anderson,27,30,Colón,28,29,Crosby,29,28,-3,-1,1
2019-09-28,3,Mulpeter,McCabe,Mulpeter,Split,Anderson,27,30,Colón,29,28,Tirelli,29,28,-3,1,1
2019-09-28,3,Coughlan,Gnusariev,Gnusariev,Unanimous,Anderson,28,29,Crosby,27,30,Tirelli,28,29,-1,-3,-1
2019-09-28,3,Burns,Nelson,Burns,Unanimous,Knudsen,29,28,Motylewski,29,28,Sutherland,29,28,1,1,1
2019-09-28,3,Oliveira,Dalby,Dalby,Unanimous,Bulow,28,29,Roberts,28,29,Wojciechowski,28,29,-1,-1,-1
2019-09-28,3,Muradov,Di Chirico,Muradov,Unanimous,Bulow,29,28,Roberts,29,28,Wojciechowski,29,28,1,1,1
2019-09-28,3,Naurdiev,Bahadurzada,Naurdiev,Unanimous,Grüner,30,26,Knudsen,30,25,Motylewski,30,25,4,5,5
2019-09-28,3,Davis,Chikadze,Chikadze,Split,Bulow,28,29,Grüner,29,28,Wojciechowski,28,29,-1,1,-1
2019-09-28,3,Lansberg,Chiasson,Lansberg,Unanimous,Knudsen,29,27,Roberts,29,28,Sutherland,29,27,2,1,2
2019-09-28,3,Diakiese,Vannata,Diakiese,Unanimous,Bulow,30,27,Grüner,30,26,Wojciechowski,30,27,3,4,3
2019-09-21,3,Esparza,Grasso,Esparza,Majority,Crosby,29,28,Puccillo,28,28,Winter,29,28,1,0,1
2019-09-21,3,Melo,Aldana,Aldana,Unanimous,Crosby,26,30,Kamijo,26,30,Puccillo,26,30,-4,-4,-4
2019-09-21,3,Huachin,Quinonez,Quinonez,Unanimous,D'Amato,27,30,Kamijo,27,30,Puga,27,30,-3,-3,-3
2019-09-21,3,Nam,Pettis,Pettis,Unanimous,Crosby,27,30,D'Amato,27,30,Winter,27,30,-3,-3,-3
2019-09-21,3,Eubanks,Correia,Correia,Unanimous,Crosby,28,29,Kamijo,28,29,Winter,28,29,-1,-1,-1
2019-09-21,3,Mariano,Puelles,Puelles,Unanimous,Cleary,25,30,Puccillo,25,30,Puga,25,30,-5,-5,-5
2019-09-21,3,Askarov,Moreno,draw,Split,D'Amato,28,28,Kamijo,29,28,Puga,27,30,0,1,-3
2019-09-14,3,Krylov,Teixeira,Teixeira,Split,Bell,29,28,D'Amato,28,29,Hagen,28,29,1,-1,-1
2019-09-14,3,Connelly,Pereira,Connelly,Unanimous,Cleary,29,27,D'Amato,29,27,Hagen,29,28,2,2,1
2019-09-14,3,Carlos Junior,Hall,Hall,Split,Bell,28,29,D'Amato,29,28,Therien,28,29,-1,1,-1
2019-09-14,3,Smith,Johns,Johns,Split,Bell,28,29,Cleary,29,28,Hagen,28,29,-1,1,-1
2019-09-14,3,Azure,Katona,Azure,Unanimous,Hagen,29,28,Therien,29,28,Welch,30,27,1,1,3
2019-09-14,3,Griffin,Skelly,Skelly,Unanimous,Bell,28,29,Cadlick,28,29,D'Amato,28,29,-1,-1,-1
2019-09-14,3,Hubbard,Prepolec,Hubbard,Unanimous,Bell,29,28,Therien,29,28,Welch,29,28,1,1,1
2019-09-14,5,De Fries,Henrique,De Fries,Split,Cartlidge,47,48,Lethaby,49,46,Wojciechowski,49,46,-1,3,3
2019-09-14,3,Soldic,Pietrzak,Soldic,Unanimous,Collett,30,27,Motylewski,29,28,Porebski,30,27,3,1,3
2019-09-14,5,Parke,Wrzosek,Parke,Split,Lethaby,47,48,Motylewski,49,46,Porebski,49,46,-1,3,3
2019-09-14,3,Radcliffe,Chmielewski,Radcliffe,Unanimous,Lethaby,29,28,Porebski,29,28,Wojciechowski,29,28,1,1,1
2019-09-07,3,Barboza,Felder,Felder,Split,Booth,30,27,Lethaby,28,29,Makhmutova,27,30,3,-1,-3
2019-09-07,3,Makhachev,Ramos,Makhachev,Unanimous,Cartlidge,29,27,Collett,30,26,Werner,30,26,2,4,4
2019-09-07,3,Ferreira,Taisumov,Ferreira,Unanimous,Booth,29,28,Collett,29,27,Lethaby,29,27,1,2,2
2019-09-07,3,Lee,Wood,Wood,Split,Cartlidge,29,28,Harasim,27,30,Makhmutova,28,29,1,-3,-1
2019-09-07,3,Akhmedov,Cummings,Akhmedov,Unanimous,Booth,30,27,Harasim,30,27,Makhmutova,29,28,3,3,1
2019-09-07,3,Madge,Ziam,Madge,Unanimous,Cartlidge,30,27,Collett,30,27,Lethaby,29,28,3,3,1
2019-09-07,3,Murphy,Tukhugov,draw,Split,Booth,29,28,Lethaby,28,28,Werner,28,29,1,0,-1
2019-09-06,3,Mearns,McAleenan,Mearns,Split,Brown,28,29,Hand,30,27,Ransom,29,28,-1,3,1
2019-09-06,3,McColgan,Ben Lakhdar,draw,Majority,Brown,28,28,Hand,27,29,Ransom,28,28,0,-2,0
2019-08-31,3,Kara-France,De La Rosa,Kara-France,Unanimous,Dimitriou,30,27,Harriman,29,28,Shen,30,27,3,1,3
2019-08-31,3,Krantz,Kenan,Kenan,Unanimous,Dimitriou,28,29,Field,28,29,Hughes,28,29,-1,-1,-1
2019-08-31,3,Inoue,Yanan,Inoue,Split,Foley,29,28,Harriman,29,28,Shen,28,29,1,1,-1
2019-08-31,3,Mudaerji,Soukhamthath,Mudaerji,Unanimous,Dimitriou,30,26,Field,30,25,Shen,30,26,4,5,4
2019-08-31,3,Ismagulov,Moises,Ismagulov,Unanimous,Dimitriou,30,26,Harriman,30,27,Shen,30,27,4,3,3
2019-08-31,3,Batgerel,Alateng,Alateng,Unanimous,Craig,27,29,Field,27,29,Foley,27,29,-2,-2,-2
2019-08-31,3,Procopio,Rosa,Rosa,Split,Harriman,28,29,Hughes,27,30,Shen,29,28,-1,-3,1
2019-08-17,3,Pettis,Diaz,Diaz,Unanimous,Bravo,28,29,Cleary,27,30,Mccarthy,27,30,-1,-3,-3
2019-08-17,3,Costa,Romero,Costa,Unanimous,Bell,29,28,Bravo,29,28,Mccarthy,29,28,1,1,1
2019-08-17,3,Heinisch,Brunson,Brunson,Unanimous,Bell,28,29,Bravo,28,29,Cleary,28,29,-1,-1,-1
2019-08-17,3,Sandhagen,Assuncao,Sandhagen,Unanimous,Bell,30,27,Cobian,29,28,Mccarthy,30,27,3,1,3
2019-08-17,3,Klose,Giagos,Klose,Unanimous,Bravo,29,28,Cobian,29,28,Mccarthy,29,28,1,1,1
2019-08-17,3,Bermudez,Kenney,Kenney,Unanimous,Bravo,28,29,Cleary,28,29,Mccarthy,28,29,-1,-1,-1
2019-08-17,3,Esquibel,Cifers,Cifers,Unanimous,Bell,28,29,Bravo,27,30,Cobian,27,30,-1,-3,-3
2019-08-17,3,Davis,Kang,Kang,Split,Cleary,28,29,Cobian,29,28,Mccarthy,28,29,-1,1,-1
2019-08-17,3,Mazo,Dobson,Mazo,Unanimous,Bell,30,25,Cobian,30,24,Mccarthy,30,25,5,6,5
2019-08-10,5,Carmouche,Shevchenko,Shevchenko,Unanimous,Bravo,45,50,Colón,45,50,Weeks,45,50,-5,-5,-5
2019-08-10,3,Luque,Perry,Luque,Split,Bravo,28,29,Colón,29,28,Terrell,29,28,-1,1,1
2019-08-10,3,Bandenay,Garagorri,Garagorri,Unanimous,Iorio,27,30,Terrell,27,30,Weeks,27,30,-3,-3,-3
2019-08-10,3,Moffett,Barzola,Barzola,Split,Colón,29,28,Iorio,27,30,Terrell,28,29,1,-3,-1
2019-08-10,3,Kunchenko,Burns,Burns,Unanimous,Bravo,28,29,Colón,28,29,Iorio,28,29,-1,-1,-1
2019-08-10,3,Rodriguez,Torres,Rodriguez,Unanimous,Bravo,30,26,Colón,30,27,Terrell,30,27,4,3,3
2019-08-10,3,Gutierrez,de Freitas Jr.,Gutierrez,Split,Iorio,29,28,Terrell,27,30,Weeks,29,28,1,-3,1
2019-08-10,3,Vargas,da Silva,da Silva,Unanimous,Alves,27,30,Bravo,27,30,Colón,27,30,-3,-3,-3
2019-08-09,5,Young,Sorenson,Sorenson,Unanimous,Champion,44,50,Divilbiss,45,49,Graham,45,48,-6,-4,-3
2019-08-09,3,VanZandt,Delboni,Delboni,Split,Champion,28,29,Divilbiss,29,28,Graham,28,29,-1,1,-1
2019-08-09,3,Geltmacher,Leonardo,Leonardo,Unanimous,Champion,28,29,Divilbiss,28,29,Graham,28,29,-1,-1,-1
2019-08-09,3,Saull,Anderson,Anderson,Split,Champion,27,30,Divilbiss,28,29,Graham,29,28,-3,-1,1
2019-08-09,3,Harpe,Norton,Harpe,Split,Champion,29,28,Divilbiss,28,29,Graham,29,27,1,-1,2
2019-08-09,3,Ottolino,Cawley,Ottolino,Unanimous,Champion,30,27,Divilbiss,30,27,Graham,30,27,3,3,3
2019-08-03,5,Covington,Lawler,Covington,Unanimous,Carolei,50,45,Colón,50,44,Tirelli,50,45,5,6,5
2019-08-03,3,Nzechukwu,Stosic,Nzechukwu,Unanimous,Bilyk,28,27,Holland,29,26,Urso,29,26,1,3,3
2019-08-03,3,Touahri,Gall,Gall,Unanimous,Colón,28,29,Tirelli,28,29,Urso,28,29,-1,-1,-1
2019-08-03,3,Granger,Goldy,Granger,Unanimous,Bilyk,30,27,Carolei,30,27,Holland,30,27,3,3,3
2019-07-27,5,Holloway,Edgar,Holloway,Unanimous,Hagen,49,46,Lee,50,45,Weeks,48,47,3,5,1
2019-07-27,3,Cyborg,Spencer,Cyborg,Unanimous,Collins,30,27,Dornan,30,27,Puccillo,30,27,3,3,3
2019-07-27,3,Aubin-Mercier,Tsarukyan,Tsarukyan,Unanimous,Collins,28,29,Lee,28,29,Puccillo,28,29,-1,-1,-1
2019-07-27,3,Barriault,Jotko,Jotko,Split,Cleary,28,29,Dornan,29,28,Hagen,28,29,-1,1,-1
2019-07-27,3,Davis,Araujo,Araujo,Unanimous,Collins,28,29,Lee,28,29,Puccillo,28,29,-1,-1,-1
2019-07-27,3,Figueiredo,Pantoja,Figueiredo,Unanimous,Cleary,30,27,Puccillo,30,27,Weeks,30,27,3,3,3
2019-07-27,3,Stewart,Koch,Koch,Unanimous,Cleary,28,29,Collins,28,29,Puccillo,27,30,-1,-1,-3
2019-07-20,5,dos Anjos,Edwards,Edwards,Unanimous,Garcia,45,50,Hillin,46,49,Rosales,46,49,-5,-3,-3
2019-07-20,3,Trinaldo,Hernandez,Hernandez,Unanimous,Carrion,27,30,Garcia,28,29,Rosales,27,30,-3,-1,-3
2019-07-20,3,Rothwell,Arlovski,Arlovski,Unanimous,Cardenas,27,30,Carrion,27,30,Hillin,27,30,-3,-3,-3
2019-07-20,3,Peterson,Caceres,Caceres,Unanimous,Cardenas,27,30,Carrion,28,29,Garcia,28,29,-3,-1,-1
2019-07-20,3,Pennington,Aldana,Pennington,Split,Carrion,28,29,Hillin,29,28,Rosales,29,28,-1,1,1
2019-07-20,3,Abreu,Alvey,Abreu,Unanimous,Cardenas,30,27,Carrion,30,27,Hillin,29,28,3,3,1
2019-07-20,3,Maia,Modafferi,Maia,Unanimous,Cardenas,30,27,Carrion,30,27,Garcia,30,27,3,3,3
2019-07-20,3,Borg,Silva,Borg,Unanimous,Carrion,29,28,Hillin,29,28,Rosales,29,28,1,1,1
2019-07-20,3,Son,Bautista,Bautista,Unanimous,Cardenas,27,30,Garcia,28,29,Hillin,27,30,-3,-1,-3
2019-07-20,3,Colares,Pilarte,Colares,Split,Cardenas,28,29,Garcia,29,28,Rosales,29,28,-1,1,1
2019-07-13,3,Turman,Roberson,Roberson,Split,Bell,28,29,Cleary,29,28,Vierra,28,29,-1,1,-1
2019-07-13,3,Ferreira,Vettori,Vettori,Unanimous,Bell,27,30,Cleary,27,30,Mccarthy,27,30,-3,-3,-3
2019-07-13,3,Pena,Montaño,Pena,Unanimous,Bell,29,28,Cleary,29,28,Mccarthy,29,27,1,1,2
2019-07-13,3,Hall,Elkins,Hall,Unanimous,Mccarthy,30,27,Rosales,29,28,Vierra,29,28,3,1,1
2019-07-13,3,Van Buren,Souza,Van Buren,Unanimous,Bell,30,27,Rosales,30,27,Vierra,30,27,3,3,3
2019-07-13,3,Morales,Lopez,Lopez,Unanimous,Grice,28,29,Rosales,28,29,Vierra,28,29,-1,-1,-1
2019-07-12,3,Kallionidou,Ellen,Ellen,Unanimous,D'Amato,28,29,Sutherland,28,29,Valel,27,30,-1,-1,-3
2019-07-12,3,Carvalho,Njokuani,Carvalho,Unanimous,D'Amato,29,28,Sutherland,29,28,Valel,29,28,1,1,1
2019-07-12,3,Robison,Dung,Dung,Unanimous,Bell,27,28,Sutherland,27,28,Valel,27,28,-1,-1,-1
2019-07-12,3,Smith,Kavanagh,Smith,Majority,Bell,29,28,D'Amato,29,28,Sutherland,28,28,1,1,0
2019-07-12,3,Jones,Fleury,Fleury,Unanimous,D'Amato,26,30,Sutherland,27,30,Valel,27,30,-4,-3,-3
2019-07-06,5,Santos,Jones,Jones,Split,Bell,47,48,Cleary,47,48,Kamijo,48,47,-1,-1,1
2019-07-06,3,Sanchez,Chiesa,Chiesa,Unanimous,Cleary,26,30,Kamijo,26,30,Morse Jarman,26,30,-4,-4,-4
2019-07-06,3,Allen,Melendez,Allen,Unanimous,Bell,30,27,D'Amato,30,27,Mccarthy,30,27,3,3,3
2019-07-06,3,Gadelha,Markos,Gadelha,Unanimous,Bell,30,27,Cleary,30,27,Mccarthy,30,27,3,3,3
2019-07-06,3,Naurdiev,Rencountre,Rencountre,Unanimous,D'Amato,27,29,Hagen,28,29,Weeks,27,30,-2,-1,-3
2019-07-06,3,Avila,Kianzad,Avila,Unanimous,Cleary,30,26,Kamijo,30,27,Morse Jarman,30,26,4,3,4
2019-06-29,3,Maia,Martin,Maia,Majority,D'Amato,29,28,Lee,29,28,Palmer,28,28,1,1,0
2019-06-29,3,Pichel,Roberts,Pichel,Unanimous,Cleary,29,28,Lee,29,28,Vogel,29,28,1,1,1
2019-06-29,3,Ramos,Newson,Ramos,Unanimous,Cleary,30,27,Palmer,30,27,Vogel,30,27,3,3,3
2019-06-29,3,Gordon,Moret,Gordon,Unanimous,Cleary,29,28,D'Amato,30,27,Shiely,30,27,1,3,3
2019-06-29,3,Amarasinghe,O'Gorman,Amarasinghe,Split,Cartlidge,29,28,Collett,28,29,Lethaby,29,28,1,-1,1
2019-06-29,3,Charriere,Monarch,Charriere,Split,Collett,29,28,Lethaby,28,29,Ransom,29,28,1,-1,1
2019-06-29,3,Crawford,Hendin,Hendin,Unanimous,Cartlidge,28,29,Collett,27,30,Lethaby,28,29,-1,-3,-1
2019-06-29,5,Frederick,Webb,draw,Majority,Collett,45,49,Lethaby,47,47,Ransom,47,47,-4,0,0
2019-06-22,5,Mousasi,Lovato Jr.,Lovato Jr.,Majority,Bell,47,48,Cartlidge,47,47,Miner,47,48,-1,0,-1
2019-06-22,3,Manhoef,Kauppinen,Manhoef,Unanimous,Bell,29,28,English,29,28,Mccarthy,29,28,1,1,1
2019-06-22,3,Daley,Silva,Daley,Unanimous,Bell,29,27,Cartlidge,29,27,Miner,29,27,2,2,2
2019-06-22,3,Labiano,Gallagher,Gallagher,Unanimous,Bell,28,29,Cartlidge,28,29,Mccarthy,28,29,-1,-1,-1
2019-06-22,3,Edwards,Bosuku,Edwards,Unanimous,Cartlidge,30,27,English,30,27,Miner,30,27,3,3,3
2019-06-22,3,Leary,Bungard,Leary,Unanimous,Bell,30,25,English,30,25,Mccarthy,30,25,5,5,5
2019-06-22,3,Ord,Rose,Ord,Unanimous,Bell,30,25,English,29,28,Peterson,30,27,5,1,3
2019-06-22,3,Kanella,Davis,Davis,Unanimous,Bell,27,29,Cartlidge,27,29,Mccarthy,27,29,-2,-2,-2
2019-06-22,3,McCabe,Bofando,Bofando,Unanimous,Bell,28,29,English,27,30,Miner,27,30,-1,-3,-3
2019-06-22,3,Redmond,Fryer,Fryer,Split,Beltran,28,29,Macdonald,29,28,Miner,28,29,-1,1,-1
2019-06-22,3,dos Santos,Ewell,Ewell,Unanimous,James,27,29,Lee,28,29,Messer,28,29,-2,-1,-1
2019-06-22,3,Lee,De La Rosa,Lee,Unanimous,Cleary,30,27,Colón,29,28,Mesardjian,30,27,3,1,3
2019-06-22,3,Di Chirico,Holland,Holland,Unanimous,D'Amato,28,29,James,28,29,Lee,28,29,-1,-1,-1
2019-06-22,3,Aguilar,Ige,Ige,Unanimous,Cleary,27,29,Colón,28,29,Messer,28,29,-2,-1,-1
2019-06-22,3,Yoder,Kondo,Yoder,Unanimous,D'Amato,30,25,Lee,30,26,Mesardjian,30,24,5,4,6
2019-06-22,3,Lipski,McCann,McCann,Unanimous,Cleary,27,30,James,27,30,Messer,27,30,-3,-3,-3
2019-06-22,3,Winn,Spicely,Winn,Unanimous,Colón,29,28,Lee,29,28,Mesardjian,29,28,1,1,1
2019-06-14,5,Gracie,MacDonald,MacDonald,Unanimous,Crosby,47,48,Lee,47,48,Tirelli,46,49,-1,-1,-3
2019-06-14,5,Horiguchi,Caldwell,Horiguchi,Unanimous,Cleary,49,46,Crosby,49,46,Tirelli,48,47,3,3,1
2019-06-14,3,Rivera,Beneduce,Beneduce,Unanimous,Cleary,27,30,Tirelli,27,30,Varela,26,30,-3,-3,-4
2019-06-14,3,Loureda,Dasch,Loureda,Unanimous,Corrado,29,28,Lee,30,27,Tirelli,30,27,1,3,3
2019-06-14,3,Kimbel,Ruiz,Kimbel,Split,Corrado,30,27,Lee,28,29,Varela,30,27,3,-1,3
2019-06-14,3,Surin,Mirkhojaev,Surin,Unanimous,Cleary,29,27,Corrado,30,27,Tirelli,29,27,2,3,2
2019-06-08,3,Rivera,Yan,Yan,Unanimous,D'Amato,28,29,Mason,28,29,Sabaitis,27,30,-1,-1,-3
2019-06-08,3,Tuivasa,Ivanov,Ivanov,Unanimous,Lee,27,30,Mason,27,30,Puccillo,28,29,-3,-3,-1
2019-06-08,3,Suarez,Nunes,Suarez,Unanimous,Mccarthy,29,28,Puccillo,29,28,Sabaitis,29,28,1,1,1
2019-06-08,3,Sterling,Munhoz,Sterling,Unanimous,Mccarthy,30,27,Puccillo,30,27,Sabaitis,30,27,3,3,3
2019-06-08,3,Kowalkiewicz,Grasso,Grasso,Unanimous,D'Amato,27,30,Lee,27,30,Mason,27,30,-3,-3,-3
2019-06-08,3,Xiaonan,Hill,Xiaonan,Unanimous,Mccarthy,29,28,Puccillo,29,28,Sabaitis,29,28,1,1,1
2019-06-08,3,Lewis,Stewart,Stewart,Unanimous,Mccarthy,28,29,Puccillo,28,29,Sabaitis,27,30,-1,-1,-3
2019-06-08,3,Chookagian,Wood,Chookagian,Unanimous,D'Amato,30,27,Lee,29,28,Mason,29,28,3,1,1
2019-06-07,3,Goodin,Wong,Goodin,Split,Champion,28,29,Divilbiss,29,28,Graham,29,28,-1,1,1
2019-06-01,3,Hadzovic,Giagos,Giagos,Unanimous,Cartlidge,28,29,Fagerlind,27,30,Lethaby,27,29,-1,-3,-2
2019-06-01,3,Teymur,Jo,Teymur,Unanimous,Fagerlind,30,27,Ohlsson,29,28,Tirelli,30,27,3,1,3
2019-06-01,3,Khandozhko,Akman,Khandozhko,Unanimous,Cartlidge,29,28,Collett,29,28,Grüner,29,28,1,1,1
2019-06-01,3,Evinger,Lansberg,Lansberg,Unanimous,Lethaby,26,30,Ohlsson,27,30,Tirelli,26,30,-4,-3,-4
2019-06-01,3,Stosic,Clark,Clark,Unanimous,Collett,28,29,Lethaby,28,29,Ohlsson,28,29,-1,-1,-1
2019-05-31,3,Barnett,Carter,Barnett,Unanimous,Cartlidge,30,26,Lethaby,29,27,Ransom,30,26,4,2,4
2019-05-31,3,Aimable,Stephen,Aimable,Unanimous,Cartlidge,29,28,Lethaby,29,28,Ransom,30,27,1,1,3
2019-05-31,3,Montagnani,Stanton,Stanton,Unanimous,Cartlidge,26,30,Lethaby,26,30,Ransom,26,30,-4,-4,-4
2019-05-18,3,Carlos Junior,Heinisch,Heinisch,Unanimous,Cleary,28,29,Corrado,28,29,Miner,28,29,-1,-1,-1
2019-05-18,3,Ramos,Hubbard,Ramos,Unanimous,Colón,30,27,D'Amato,30,27,Miner,30,27,3,3,3
2019-05-18,3,Eubanks,Ladd,Ladd,Unanimous,Cleary,28,29,Colón,26,30,Miner,27,29,-1,-4,-2
2019-05-18,3,Green,Jourdain,Green,Unanimous,Colón,29,28,Corrado,30,27,Miner,30,27,1,3,3
2019-05-18,3,Sowinski,Parke,Parke,Unanimous,Bonkowski,27,30,Cartlidge,27,30,Wojciechowski,27,30,-3,-3,-3
2019-05-18,3,Zawada,Silva,Zawada,Unanimous,Collett,29,28,Lethaby,29,27,Wojciechowski,29,27,1,2,2
2019-05-18,3,Racic,Politylo,Racic,Split,Bonkowski,29,28,Cartlidge,29,28,Wojciechowski,28,29,1,1,-1
2019-05-18,3,Krakowski,Dubois,Krakowski,Majority,Collett,29,28,Kloc,29,28,Lethaby,28,28,1,1,0
2019-05-11,3,Curran,McKee,McKee,Unanimous,Caldwell,28,29,Jones,27,30,Lee,27,30,-1,-3,-3
2019-05-11,3,Ward,Amartuvshin,Amartuvshin,Unanimous,Caldwell,28,29,Mccarthy,28,29,Sabaitis,28,29,-1,-1,-1
2019-05-11,3,Gonzalez,Radtke,Gonzalez,Unanimous,Bell,29,28,Lee,29,28,Mason,29,28,1,1,1
2019-05-11,3,Diehl,Bazzi,Bazzi,Unanimous,Caldwell,27,30,Janecek,27,30,Mccarthy,27,30,-3,-3,-3
2019-05-11,3,Aldo,Volkanovski,Volkanovski,Unanimous,Bravo,27,30,D'Amato,27,30,Tirelli,27,30,-3,-3,-3
2019-05-11,3,Staropoli,Alves,Staropoli,Unanimous,Cleary,29,28,D'Amato,30,27,Vilhena,30,27,1,3,3
2019-05-11,3,Holobaugh,Moises,Moises,Unanimous,Alves,26,30,Bravo,26,30,D'Amato,27,30,-4,-4,-3
2019-05-11,3,Penn,Guida,Guida,Unanimous,Alves,28,29,Cleary,28,29,Pontes,27,29,-1,-1,-2
2019-05-11,3,Cachoeira,Carolina,Carolina,Unanimous,Alves,26,30,Pontes,27,29,Tirelli,26,30,-4,-2,-4
2019-05-04,5,Cerrone,Iaquinta,Cerrone,Unanimous,Colón,49,45,Rodgers,49,45,Tirelli,49,46,4,4,3
2019-05-04,3,Theodorou,Brunson,Brunson,Unanimous,Colón,28,29,Therien,28,29,Tirelli,27,30,-1,-1,-3
2019-05-04,3,Burgos,Swanson,Burgos,Split,Colón,29,28,Therien,27,30,Woods,30,27,1,-3,3
2019-05-04,3,Dvalishvili,Katona,Dvalishvili,Unanimous,Rodgers,30,27,Tirelli,30,27,Woods,30,27,3,3,3
2019-05-04,3,Sanchez,Barriault,Sanchez,Unanimous,Colón,29,28,Therien,29,28,Woods,29,28,1,1,1
2019-05-04,3,Zahabi,Morales,Morales,Unanimous,Costello,28,29,Rodgers,28,29,Tirelli,28,29,-1,-1,-1
2019-05-04,3,Prepolec,Taleb,Taleb,Unanimous,Colón,27,30,Haniff,27,30,Rodgers,27,30,-3,-3,-3
2019-05-04,3,Adams,Bhullar,Bhullar,Unanimous,Buckley,28,29,Therien,28,29,Tirelli,27,30,-1,-1,-3
2019-05-04,3,Gagnon,Smith,Smith,Unanimous,Rodgers,28,29,Tirelli,27,30,Vandermeer,28,29,-1,-3,-1
2019-05-04,3,Lee,Rogers,Rogers,Unanimous,Bell,27,30,Cartlidge,27,30,Crosby,27,30,-3,-3,-3
2019-05-04,3,Moore,Son Le,Moore,Unanimous,Bell,30,26,Cartlidge,30,25,Miner,30,25,4,5,5
2019-05-04,3,Mousah,Piskorz,Mousah,Unanimous,Bell,30,27,Cartlidge,30,27,Crosby,30,27,3,3,3
2019-05-04,3,Chadwick,Mulheron,Chadwick,Unanimous,Bell,29,28,Cartlidge,30,27,Miner,30,27,1,3,3
2019-05-04,3,Pietrini,Wallhead,Wallhead,Unanimous,Bell,26,30,Cartlidge,27,29,Crosby,27,30,-4,-2,-3
2019-05-04,3,Turner,Reece,Reece,Unanimous,Bell,27,30,Crosby,27,30,Roberts,27,30,-3,-3,-3
2019-05-04,3,Gnusariev,Lister,draw,Split,Cartlidge,29,28,Crosby,27,28,Miner,28,28,1,-1,0
2019-05-03,3,Sormova,Hansen,Sormova,Split,Champion,28,29,Divilbiss,29,28,Graham,29,28,-1,1,1
2019-04-27,5,Souza,Hermansson,Hermansson,Unanimous,Cleary,45,49,D'Amato,47,48,Lee,47,48,-4,-1,-1
2019-04-27,3,Oliveira,Perry,Perry,Unanimous,Cleary,28,29,D'Amato,28,29,Torres,28,29,-1,-1,-1
2019-04-27,3,Lineker,Sandhagen,Sandhagen,Split,Cleary,28,29,Lee,29,28,Luxenberg,28,29,-1,1,-1
2019-04-27,3,Roberts,Gifford,Roberts,Unanimous,Cleary,30,27,D'Amato,30,27,Lee,30,27,3,3,3
2019-04-27,3,Arlovski,Sakai,Sakai,Split,Cleary,29,28,Lee,28,29,Wincapaw,28,29,1,-1,-1
2019-04-27,3,Jandiroba,Esparza,Esparza,Unanimous,Cleary,28,29,D'Amato,28,29,Luxenberg,27,30,-1,-1,-3
2019-04-27,3,Esquibel,Hill,Hill,Unanimous,Luxenberg,28,29,Torres,27,30,Wincapaw,27,30,-1,-3,-3
2019-04-27,3,Lima,McGee,Lima,Split,Bertrand,28,29,D'Amato,30,27,Lee,29,28,-1,3,1
2019-04-27,3,Henderson,Piccolotti,Henderson,Split,Guingona,28,29,Maness,29,28,Rosales,29,28,-1,1,1
2019-04-27,3,Desmae,Jones,Jones,Unanimous,Cartlidge,27,30,Collett,28,29,Lethaby,27,30,-3,-1,-3
2019-04-27,3,Abraham,Edwards,Edwards,Unanimous,Cartlidge,27,30,Collett,28,29,Lethaby,27,30,-3,-1,-3
2019-04-27,3,Reed,De Paepe,Reed,Unanimous,Cartlidge,29,28,Collett,29,28,Lethaby,29,28,1,1,1
2019-04-27,3,Szadzinski,Ziolkowski,Ziolkowski,Unanimous,Motylewski,25,30,Niemkowicz,26,30,Werner,26,30,-5,-4,-4
2019-04-27,5,Fitch,MacDonald,draw,Majority,Bell,47,47,Maness,48,46,Mccarthy,47,47,0,2,0
2019-04-20,3,Makhachev,Tsarukyan,Makhachev,Unanimous,Bosacki,30,27,Hughes,30,27,Lethaby,29,28,3,3,1
2019-04-20,3,Shevchenko,Modafferi,Modafferi,Split,Collett,28,29,Hughes,28,29,Makhmutova,29,28,-1,-1,1
2019-04-20,3,Amedovski,Jotko,Jotko,Unanimous,Cartlidge,25,30,Lethaby,26,30,Motylewski,26,30,-5,-4,-4
2019-04-20,3,Evloev,Choi,Evloev,Unanimous,Bosacki,29,27,Hughes,29,26,Makhmutova,29,27,2,3,2
2019-04-20,3,Aliev,Nakamura,Aliev,Unanimous,Bosacki,30,27,Collett,30,27,Hughes,30,27,3,3,3
2019-04-13,5,Holloway,Poirier,Poirier,Unanimous,Bell,46,49,Cleary,46,49,D'Amato,46,49,-3,-3,-3
2019-04-13,5,Gastelum,Adesanya,Adesanya,Unanimous,Bell,46,48,Coffey,46,48,Maness,46,48,-2,-2,-2
2019-04-13,3,Rountree Jr.,Anders,Rountree Jr.,Unanimous,D'Amato,30,26,Fisher,30,26,Mann,30,26,4,4,4
2019-04-13,3,Jouban,Grant,Grant,Split,Cleary,28,29,Coffey,28,29,Maness,30,27,-1,-1,3
2019-04-13,3,Turner,Frevola,Frevola,Unanimous,Cleary,27,30,D'Amato,27,30,Fisher,27,30,-3,-3,-3
2019-04-13,3,Griffin,Imadaev,Griffin,Majority,Bell,28,28,Cleary,29,27,Fisher,29,27,0,2,2
2019-04-13,3,Muhammad,Millender,Muhammad,Unanimous,Bell,29,27,Cleary,29,27,D'Amato,30,26,2,2,4
2019-04-13,3,Soukhamthath,Jackson,Jackson,Unanimous,Coffey,26,30,Fisher,27,29,Maness,27,30,-4,-2,-3
2019-04-13,3,Mueller,Botelho,Botelho,Unanimous,Cleary,28,29,D'Amato,28,29,Mann,28,29,-1,-1,-1
2019-03-30,3,Kowalkiewicz,Waterson-Gomez,Waterson-Gomez,Unanimous,Cintron,27,30,Tirelli,27,30,Urso,27,30,-3,-3,-3
2019-03-30,3,Moraes,Yusuff,Yusuff,Unanimous,Brogan,28,29,Colón,28,29,Tirelli,27,29,-1,-1,-2
2019-03-30,3,Rodriguez,Aguilar,Rodriguez,Unanimous,Brogan,29,27,Cintron,29,27,Urso,29,26,2,2,3
2019-03-30,3,Barzola,Aguilar,Aguilar,Unanimous,Cintron,28,29,Colón,28,29,Urso,28,29,-1,-1,-1
2019-03-30,3,Holland,Meerschaert,Holland,Split,Monskie,29,28,Tirelli,28,29,Urso,30,27,1,-1,3
2019-03-30,3,Borg,Kenney,Kenney,Unanimous,Brogan,28,29,Colflesh,28,29,Colón,27,30,-1,-1,-3
2019-03-30,3,Moroz,Mazo,Moroz,Unanimous,Cintron,29,28,Colflesh,29,28,Tirelli,30,27,1,1,3
2019-03-30,3,Perez,De La Rosa,Perez,Unanimous,Brogan,30,27,Monskie,30,27,Urso,30,27,3,3,3
2019-03-29,3,Awad,Girtz,Girtz,Unanimous,Bell,27,30,Denkin,28,29,Mccarthy,28,29,-3,-1,-1
2019-03-29,3,Koreshkov,Jasper,Koreshkov,Unanimous,Bell,30,27,Denkin,30,27,Mccarthy,30,27,3,3,3
2019-03-29,3,Berry,Schilling,Schilling,Unanimous,Bell,26,30,Mccarthy,26,30,Rathgeber,26,30,-4,-4,-4
2019-03-23,5,De Fries,Narkun,De Fries,Unanimous,Bonkowski,50,44,Collett,50,45,Lethaby,50,44,6,5,6
2019-03-23,3,Parke,Mankowski,Parke,Unanimous,Collett,29,28,Lethaby,29,28,Porebski,29,28,1,1,1
2019-03-23,3,Ishii,Rodrigues Jr.,Ishii,Split,Kloc,28,29,Pawlega,29,28,Porebski,30,27,-1,1,3
2019-03-23,3,Klaczek,Wrzosek,Wrzosek,Unanimous,Bonkowski,26,30,Collett,25,30,Kloc,26,30,-4,-5,-4
2019-03-23,3,Chojnoska,Owczarz,Owczarz,Split,Lethaby,28,29,Pawlega,28,29,Porebski,29,28,-1,-1,1
2019-03-23,3,Kazieczko,Kopera,Kazieczko,Majority,Kloc,30,26,Pawlega,29,28,Porebski,28,28,4,1,0
2019-03-23,3,Willis,Blaydes,Blaydes,Unanimous,Cleary,25,30,Puccillo,26,30,Winter,27,30,-5,-4,-3
2019-03-23,3,Pinedo,Makdessi,Makdessi,Unanimous,Maness,28,29,Weeks,27,30,Winter,27,30,-1,-3,-3
2019-03-23,3,Figueiredo,Formiga,Formiga,Unanimous,Cleary,27,30,Puccillo,28,29,Sarratt,28,29,-3,-1,-1
2019-03-23,3,Peterson,Pena,Pena,Unanimous,D'Amato,27,30,Puccillo,27,30,Weeks,27,30,-3,-3,-3
2019-03-23,3,Moffett,Mitchell,Mitchell,Unanimous,D'Amato,28,29,Maness,28,29,Weeks,28,29,-1,-1,-1
2019-03-23,3,Maia,Davis,Maia,Unanimous,D'Amato,29,28,Maness,29,28,Weeks,29,28,1,1,1
2019-03-23,3,MacDonald,Gutierrez,Gutierrez,Unanimous,D'Amato,27,30,Weeks,27,30,Winter,27,30,-3,-3,-3
2019-03-23,3,Shelton,Espinosa,Espinosa,Unanimous,Cleary,28,29,Maness,27,30,Puccillo,27,30,-1,-3,-3
2019-03-22,3,Karakhanyan,Sanchez,Sanchez,Unanimous,Bell,28,29,Mccarthy,28,29,Sutherland,28,29,-1,-1,-1
2019-03-22,3,Vassell,Moldavsky,Moldavsky,Unanimous,Anderson,27,29,Bell,27,29,Mccarthy,27,29,-2,-2,-2
2019-03-22,3,Kouzmin,Bennett,Kouzmin,Unanimous,Anderson,30,27,Mccarthy,30,27,Sutherland,30,27,3,3,3
2019-03-16,3,Edwards,Nelson,Edwards,Split,Hughes,28,29,Ohlsson,29,27,Roberts,29,28,-1,2,1
2019-03-16,3,Reyes,Oezdemir,Reyes,Split,Kamijo,29,28,Roberts,28,29,Sutherland,29,28,1,-1,1
2019-03-16,3,Marshman,Phillips,Marshman,Split,Collett,29,28,Harasim,28,29,Roberts,29,28,1,-1,1
2019-03-16,3,Allen,Rinaldi,Allen,Unanimous,Harasim,30,26,Ohlsson,30,27,Sutherland,29,28,4,3,1
2019-03-16,3,Diakiese,Duffy,Diakiese,Unanimous,Collett,30,27,Kamijo,30,27,Roberts,30,27,3,3,3
2019-03-16,3,Safarov,Negumereanu,Safarov,Unanimous,Hughes,29,26,Ohlsson,29,26,Sutherland,29,27,3,3,2
2019-03-16,3,Cachoeira,McCann,McCann,Unanimous,Collett,28,29,Hughes,28,29,Sutherland,28,29,-1,-1,-1
2019-03-09,5,Charriere,Bak,Bak,Majority,Cartlidge,47,47,Collett,47,48,Lethaby,46,49,0,-1,-3
2019-03-09,3,Madsen,Larchet,Madsen,Unanimous,Cartlidge,30,27,Collett,30,27,Lethaby,30,27,3,3,3
2019-03-09,3,Promanee,Segas,Segas,Unanimous,Cartlidge,28,29,Collett,28,29,Lethaby,28,29,-1,-1,-1
2019-03-09,3,Ivanov,Rothwell,Ivanov,Unanimous,Champion,29,28,Cleary,29,28,D'Amato,29,28,1,1,1
2019-03-09,3,Akhmedov,Boetsch,Akhmedov,Unanimous,Champion,30,27,Cleary,30,27,D'Amato,30,27,3,3,3
2019-03-09,3,Martin,Moraes,Martin,Unanimous,Bell,30,27,Divilbiss,30,27,Lee,30,27,3,3,3
2019-03-09,3,Reneau,Kunitskaya,Kunitskaya,Unanimous,Champion,28,29,Cleary,28,29,D'Amato,28,29,-1,-1,-1
2019-03-09,3,Dawson,Erosa,Dawson,Unanimous,Bell,29,27,Cleary,30,27,Lee,30,26,2,3,4
2019-03-09,3,Greene,Hughes,Greene,Split,Bell,29,28,Champion,29,28,D'Amato,28,29,1,1,-1
2019-03-09,3,Moret,White,White,Unanimous,Bell,28,29,Divilbiss,28,29,Lee,28,29,-1,-1,-1
2019-03-02,5,Jones,Smith,Jones,Unanimous,D'Amato,48,44,Kamijo,48,44,Lee,48,44,4,4,4
2019-03-02,5,Usman,Woodley,Usman,Unanimous,Bell,50,44,Cleary,50,45,Hagen,50,44,6,5,6
2019-03-02,3,Zhang,Torres,Zhang,Unanimous,Bell,29,28,Cleary,30,27,Trowbridge,30,27,1,3,3
2019-03-02,3,Stephens,Magomedsharipov,Magomedsharipov,Unanimous,Bell,28,29,Cleary,28,29,Weeks,28,29,-1,-1,-1
2019-03-02,3,Stamann,Perez,Stamann,Unanimous,Cleary,29,28,Hagen,30,27,Weeks,29,28,1,3,1
2019-03-02,3,Cifers,Viana,Cifers,Split,Hagen,28,29,Mccarthy,29,28,Weeks,29,28,-1,1,1
2019-03-02,3,White,Santos,Santos,Unanimous,Cartlidge,27,30,Collett,27,30,Lethaby,27,30,-3,-3,-3
2019-03-02,3,Creasey,Young,Creasey,Unanimous,Cartlidge,29,28,Collett,30,27,Lethaby,30,27,1,3,3
2019-03-02,3,Bouland,Tait,Bouland,Majority,Cartlidge,28,28,Collett,29,27,Lethaby,29,27,0,2,2
2019-03-02,3,Aimable,McAleenan,Aimable,Majority,Cartlidge,29,27,Collett,28,28,Lethaby,29,27,2,0,2
2019-03-02,3,Crawford,Stephen,Stephen,Unanimous,Cartlidge,28,29,Collett,27,30,Lethaby,28,29,-1,-3,-1
2019-02-23,3,Carmouche,Pudilova,Carmouche,Unanimous,Cartlidge,29,28,Collett,30,27,Lethaby,29,28,1,3,1
2019-02-23,3,Yan,Dodson,Yan,Unanimous,Collett,30,27,Grüner,30,27,Wojciechowski,30,27,3,3,3
2019-02-23,3,Abreu,Ankalaev,Ankalaev,Unanimous,Cartlidge,27,30,Lethaby,28,29,Sutherland,27,30,-3,-1,-3
2019-02-23,3,Naurdiev,Prazeres,Naurdiev,Unanimous,Collett,30,27,Grüner,30,27,Lethaby,30,26,3,3,4
2019-02-23,3,Ferreira,Khabilov,Ferreira,Unanimous,Lethaby,29,28,Sutherland,30,27,Wojciechowski,30,27,1,3,3
2019-02-23,3,Ismagulov,Alvarez,Ismagulov,Unanimous,Cartlidge,30,27,Collett,30,27,Ledvina,30,27,3,3,3
2019-02-17,3,Felder,Vick,Felder,Unanimous,Bell,30,27,Cleary,30,27,Porrata,29,28,3,3,1
2019-02-17,3,Casey,Calvillo,Calvillo,Unanimous,Cleary,28,29,Lee,27,30,O'connell,28,29,-1,-3,-1
2019-02-17,3,Fili,Jury,Fili,Unanimous,Cleary,29,28,Lee,29,28,Porrata,29,28,1,1,1
2019-02-17,3,Rivera,Sterling,Sterling,Unanimous,Bell,27,30,Flores,27,30,Lee,27,30,-3,-3,-3
2019-02-17,3,Lee,Evans-Smith,Lee,Unanimous,Cleary,30,27,Lee,30,27,Porrata,30,27,3,3,3
2019-02-17,3,Holtzman,Lentz,Lentz,Unanimous,Bell,28,29,Flores,28,29,O'connell,28,29,-1,-1,-1
2019-02-16,3,Fleminas,Bonner,Fleminas,Split,Cartlidge,29,28,Collett,29,28,Lethaby,28,29,1,1,-1
2019-02-16,3,Stanton,Ebanks,Stanton,Unanimous,Cartlidge,30,25,Collett,30,26,Lethaby,30,26,5,4,4
2019-02-16,3,O'Connor,Hooper,O'Connor,Unanimous,Cartlidge,30,27,Collett,30,27,Lethaby,30,26,3,3,4
2019-02-16,3,Kinsella,Wojtyna,Kinsella,Unanimous,Cartlidge,29,28,Collett,29,28,Lethaby,29,28,1,1,1
2019-02-16,3,Wilson,Ettridge,Wilson,Unanimous,Cartlidge,30,25,Collett,30,25,Lethaby,30,26,5,5,4
2019-02-16,3,Sheehan,Machado Garry,Machado Garry,Unanimous,Cartlidge,25,30,Collett,27,30,Lethaby,25,30,-5,-3,-5
2019-02-16,3,Lofthouse,Kelly,Kelly,Unanimous,Cartlidge,27,30,Collett,27,30,Lethaby,27,30,-3,-3,-3
2019-02-16,5,Daley,Page,Page,Unanimous,Colón,47,48,D'Amato,47,48,Miner,47,48,-1,-1,-1
2019-02-16,3,Nelson,Filipovic,Filipovic,Unanimous,D'Amato,27,30,Miner,28,29,Peabody,28,29,-3,-1,-1
2019-02-16,3,Minakov,Kongo,Kongo,Unanimous,Colón,28,29,Peabody,28,29,Tirelli,27,30,-1,-1,-3
2019-02-16,3,Silva,Amosov,Amosov,Unanimous,Colón,28,29,D'Amato,27,29,Peabody,28,29,-1,-2,-1
2019-02-15,3,Pascu,Storley,Storley,Unanimous,Colón,26,30,Miner,27,30,Tirelli,27,30,-4,-3,-3
2019-02-15,3,Misech,Dantas,Dantas,Unanimous,D'Amato,28,29,Miner,27,30,Tirelli,27,30,-1,-3,-3
2019-02-15,3,Goff,Hardy Evans,Goff,Unanimous,Colón,29,28,Miner,29,28,Peabody,29,28,1,1,1
2019-02-15,3,Adashev,Arana,Adashev,Unanimous,Colón,30,27,Peabody,30,27,Tirelli,29,28,3,3,1
2019-02-15,3,Probin,Zebian,Probin,Split,Colón,29,28,D'Amato,29,28,Tirelli,28,29,1,1,-1
2019-02-15,3,Dudieva,Rodriguez,Rodriguez,Split,Champion,28,29,Divilbiss,28,29,Graham,29,28,-1,-1,1
2019-02-15,3,Cortez,Blanchfield,Cortez,Split,Champion,29,28,Divilbiss,29,28,Graham,28,29,1,1,-1
2019-02-10,3,Adesanya,Silva,Adesanya,Unanimous,Harriman,29,28,Keech,30,27,Shen,30,27,1,3,3
2019-02-10,3,Simon,Yahya,Simon,Unanimous,Craig,30,27,Dimitriou,30,25,Shen,30,27,3,5,3
2019-02-10,3,Young,Arnett,Young,Unanimous,Field,30,27,Keech,30,27,Shen,30,27,3,3,3
2019-02-10,3,Kara-France,Paiva,Kara-France,Split,Cleary,29,28,Harriman,28,29,Shen,29,28,1,-1,1
2019-02-10,3,Martinez,Buren,Martinez,Unanimous,Dimitriou,30,27,Field,29,28,Harriman,30,27,3,1,3
2019-02-09,3,Scope,Freire,Freire,Split,Colón,29,28,Miner,28,29,Tirelli,28,29,1,-1,-1
2019-02-09,3,Edwards,Chadwick,Edwards,Unanimous,Colón,30,27,Miner,30,26,Tirelli,30,27,3,4,3
2019-02-09,3,Wallhead,Lloveras,Wallhead,Unanimous,Colón,30,27,Miner,30,27,Tirelli,29,28,3,3,1
2019-02-02,3,Frota,Souza,Souza,Split,Bravo,28,29,Pontes,29,28,Terrell,28,29,-1,1,-1
2019-02-02,3,Romero Borella,Santos,Romero Borella,Split,Lee,28,29,Pontes,29,28,Terrell,29,28,-1,1,1
2019-02-02,3,Griffin,Alves,Alves,Split,Bell,29,28,Bravo,28,29,Pontes,28,29,1,-1,-1
2019-02-02,3,de Freitas Jr.,Colares,de Freitas Jr.,Unanimous,Bell,30,27,Bravo,30,26,Lee,30,27,3,4,3
2019-02-02,3,Bibulatov,Bontorin,Bontorin,Split,Bell,28,29,Bravo,29,28,Terrell,28,29,-1,1,-1
2019-01-26,3,Archuleta,Bandejas,Archuleta,Unanimous,Bell,29,28,Denkin,29,28,Maness,29,28,1,1,1
2019-01-26,3,Agazarm,Roberts,Roberts,Split,Cleary,28,29,Cobian,28,29,Rosales,29,28,-1,-1,1
2019-01-26,3,Butler,Plaskett,Plaskett,Unanimous,Maness,27,30,Mccarthy,27,30,Rosales,27,30,-3,-3,-3
2019-01-19,3,Benavidez,Ortiz,Benavidez,Unanimous,Corrado,29,28,Crosby,29,28,Porter,29,28,1,1,1
2019-01-19,3,Lipski,Wood,Wood,Unanimous,D'Amato,26,30,Porter,26,30,Tirelli,27,30,-4,-4,-3
2019-01-19,3,Edwards,Bermudez,Bermudez,Unanimous,Crosby,26,30,D'Amato,26,30,Porter,26,30,-4,-4,-4
2019-01-19,3,Muhammad,Neal,Neal,Unanimous,Colón,27,30,Corrado,27,30,D'Amato,28,29,-3,-3,-1
2018-12-29,3,Latifi,Anderson,Anderson,Unanimous,Cleary,28,29,Kamijo,28,29,Vierra,28,29,-1,-1,-1
2018-12-29,3,Arlovski,Harris,Harris,Split,Hagen,30,27,Mccarthy,28,29,Vierra,28,29,3,-1,-1
2018-12-29,3,Millender,Bahadurzada,Millender,Unanimous,Bell,30,27,D'Amato,29,28,Hagen,29,28,3,1,1
2018-12-15,5,Grusander,Frey,Frey,Split,Gueary,47,48,Marquez,48,47,Miller,47,48,-1,1,-1
2018-12-15,5,Iaquinta,Lee,Iaquinta,Unanimous,D'Amato,48,47,Lee,49,46,Puccillo,48,47,1,3,1
2018-12-15,3,Pettis,Font,Font,Unanimous,Lee,27,30,Puccillo,27,30,Winter,27,30,-3,-3,-3
2018-12-15,3,Grant,Ottow,Ottow,Split,Lee,28,29,Puccillo,29,28,Winter,28,29,-1,1,-1
2018-12-15,3,Green,Klose,Klose,Unanimous,D'Amato,28,29,Puccillo,28,29,Winter,28,29,-1,-1,-1
2018-12-15,3,Smith,Cummings,Cummings,Unanimous,D'Amato,28,29,Sabaitis,28,29,Struck,28,29,-1,-1,-1
2018-12-15,3,Ige,Griffin,Ige,Unanimous,Lee,29,28,Puccillo,29,28,Winter,29,28,1,1,1
2018-12-15,3,Carvalho,Machida,Machida,Split,Colón,29,28,Mccarthy,28,29,Onzuka,28,29,1,-1,-1
2018-12-15,3,Kamaka III,Miki,Kamaka III,Unanimous,Bell,29,28,Furuta,29,28,Mccarthy,29,28,1,1,1
2018-12-14,5,Primus,Chandler,Chandler,Unanimous,Bell,45,50,Colón,45,50,Mccarthy,45,50,-5,-5,-5
2018-12-14,3,Lara,Velasquez,Velasquez,Split,Bell,27,30,Colón,29,28,Onzuka,28,29,-3,1,-1
2018-12-08,5,Shevchenko,Jedrzejczyk,Shevchenko,Unanimous,Colón,49,46,Rodgers,49,46,Roussel,49,46,3,3,3
2018-12-08,3,Dawodu,Bochniak,Dawodu,Split,Colón,30,27,Rodgers,30,27,Roussel,28,29,3,3,-1
2018-12-08,3,Gadelha,Nunes,Nunes,Unanimous,Jackson,28,29,Therien,28,29,Woods,28,29,-1,-1,-1
2018-12-08,3,Burns,Aubin-Mercier,Burns,Unanimous,Colón,30,27,D'Amato,29,28,Woods,30,27,3,1,3
2018-12-08,3,Eye,Chookagian,Eye,Split,Jackson,29,28,Roussel,28,29,Woods,29,28,1,-1,1
2018-12-08,3,Theodorou,Anders,Theodorou,Split,D'Amato,29,28,Doyle,29,28,Roussel,28,29,1,1,-1
2018-12-08,3,Katona,Lopez,Katona,Unanimous,D'Amato,29,28,Goulah,30,27,Rodgers,29,28,1,3,1
2018-12-02,3,Hunt,Willis,Willis,Unanimous,Booth,28,29,Dimitriou,28,29,Field,28,29,-1,-1,-1
2018-12-02,3,Okami,Kunchenko,Kunchenko,Unanimous,Booth,27,30,Field,26,30,Keech,26,30,-3,-4,-4
2018-12-02,3,Nguyen,Reis,Reis,Unanimous,Dimitriou,27,30,Hughes,27,30,Papaioannou,27,30,-3,-3,-3
2018-12-02,3,Touahri,Nakamura,Nakamura,Split,Booth,27,30,Hughes,29,28,Keech,28,29,-3,1,-1
2018-12-02,3,Garcia,Kara-France,Kara-France,Unanimous,Dimitriou,25,30,Field,26,30,Papaioannou,25,30,-5,-4,-5
2018-12-02,3,Giagos,Hirota,Giagos,Unanimous,Booth,29,27,Hughes,29,28,Papaioannou,30,28,2,1,2
2018-12-02,3,Gorgees,Ismagulov,Ismagulov,Unanimous,Dimitriou,25,30,Field,26,30,Keech,26,30,-5,-4,-4
2018-12-01,3,Khalidov,Narkun,Narkun,Unanimous,Cartlidge,27,30,Lethaby,28,29,Pawlega,28,29,-3,-1,-1
2018-12-01,5,Koike,Gamrot,Gamrot,Unanimous,Lethaby,44,50,Novak,45,50,Wojciechowski,45,50,-6,-5,-5
2018-12-01,3,Parnasse,Wrzosek,Parnasse,Unanimous,Cartlidge,30,27,Novak,30,27,Porebski,30,27,3,3,3
2018-12-01,3,Torres,Szymanski,Szymanski,Unanimous,Lethaby,28,29,Novak,28,29,Pawlega,28,29,-1,-1,-1
2018-12-01,3,Ziolkowski,Szulakowski,Ziolkowski,Unanimous,Cartlidge,30,25,Werner,30,26,Wojciechowski,30,27,5,4,3
2018-12-01,3,Sowinski,Szymuszowski,Sowinski,Unanimous,Cartlidge,29,28,Porebski,29,28,Werner,29,28,1,1,1
2018-12-01,3,Racic,Przybysz,Racic,Unanimous,Lethaby,30,27,Pawlega,30,27,Wojciechowski,30,27,3,3,3
2018-12-01,3,D'Ambrosio,Crosbie,Crosbie,Unanimous,Cleary,27,30,D'Amato,27,30,Miner,27,30,-3,-3,-3
2018-12-01,3,Fusi,Pugliesi,Fusi,Split,Cleary,29,28,D'Amato,29,28,Miner,28,29,1,1,-1
2018-12-01,12,Fury,Wilder,draw,Split,Edwards,113,113,Rochin,111,115,Tapper,114,112,0,-4,2
2018-11-30,5,Usman,dos Anjos,Usman,Unanimous,Hagen,49,45,Kamijo,50,43,Lee,48,47,4,7,1
2018-11-30,3,Shahbazyan,Stewart,Shahbazyan,Split,Kamijo,28,29,Lee,29,28,Morse Jarman,29,28,-1,1,1
2018-11-30,3,Shevchenko,Kim,Shevchenko,Unanimous,Hagen,30,27,Weeks,30,27,Winter,30,27,3,3,3
2018-11-30,3,Aguilar,Glenn,Aguilar,Unanimous,Byrd,30,27,Lee,30,27,Trowbridge,30,27,3,3,3
2018-11-30,3,Letson,Stoliarenko,Letson,Split,Byrd,28,29,Kamijo,29,28,Mccarthy,29,28,-1,1,1
2018-11-30,3,Rickels,Bomba,Rickels,Unanimous,Bell,29,28,Montalvo,30,27,Turnage,29,28,1,3,1
2018-11-30,3,Williams,Ellen,Williams,Unanimous,Bell,29,28,Mathisen,30,27,Turnage,30,27,1,3,3
2018-11-30,3,Spoon,Archuleta,Archuleta,Unanimous,Mathisen,25,30,Montalvo,26,30,Turnage,26,30,-5,-4,-4
2018-11-30,3,Honeycutt,van Steenis,van Steenis,Split,Mathisen,28,29,Montalvo,28,29,Turnage,29,28,-1,-1,1
2018-11-30,3,Yamauchi,Weichel,Yamauchi,Split,Bell,30,27,Montalvo,29,28,Turnage,27,30,3,1,-3
2018-11-24,3,Yadong,Morales,Yadong,Unanimous,Harriman,30,27,Shen,30,27,Sutherland,30,27,3,3,3
2018-11-24,3,Kenan,Morono,Morono,Unanimous,Craig,27,30,Harriman,27,30,Sutherland,27,30,-3,-3,-3
2018-11-24,3,Coulter,Yaozong,Coulter,Unanimous,Craig,29,28,Foley,29,28,Harriman,30,27,1,1,3
2018-11-24,3,Pingyuan,Day,Pingyuan,Split,Craig,29,28,Foley,28,29,Harriman,29,28,1,-1,1
2018-11-24,3,Kondo,Xiaonan,Xiaonan,Unanimous,Harriman,27,30,Shen,27,30,Sutherland,27,30,-3,-3,-3
2018-11-17,3,Heinisch,Ferreira,Heinisch,Unanimous,Bell,30,27,Bravo,29,28,Terrell,29,28,3,1,1
2018-11-17,3,Bandenay,Arnett,Arnett,Unanimous,Bravo,27,29,Pontes,27,29,Terrell,28,29,-2,-2,-1
2018-11-17,3,Aldana,Staropoli,Staropoli,Unanimous,Bell,27,30,Pontes,27,30,Terrell,27,30,-3,-3,-3
2018-11-17,3,Powell,Pinedo,Pinedo,Unanimous,Bell,28,29,Pontes,27,30,Terrell,27,30,-1,-3,-3
2018-11-17,3,dos Santos,Narimani,Narimani,Unanimous,Bell,27,30,Bravo,27,30,Pontes,27,30,-3,-3,-3
2018-11-17,3,Jones,Wheeler,Jones,Unanimous,Cartlidge,29,27,Collett,29,27,Lethaby,29,28,2,2,1
2018-11-17,3,Aimable,Abraham,Aimable,Unanimous,Cartlidge,29,28,Collett,30,27,Lethaby,30,26,1,3,4
2018-11-16,3,Blanchfield,Hansen,Blanchfield,Majority,Bower,29,28,English,29,28,Scott,28,28,1,1,0
2018-11-15,5,Sanchez,Freire,Freire,Unanimous,D'Amato,47,48,Miner,46,48,Tirelli,47,48,-1,-2,-1
2018-11-15,3,Couture,Gozali,Couture,Unanimous,D'Amato,30,26,English,29,27,Tirelli,30,27,4,2,3
2018-11-15,3,Nemkov,Davis,Nemkov,Split,D'Amato,29,28,Miner,28,29,Tirelli,29,28,1,-1,1
2018-11-15,3,Dandois,Rubin,Rubin,Unanimous,English,28,29,Miner,28,29,Tirelli,27,30,-1,-1,-3
2018-11-15,3,Honorio,Sholinian,Honorio,Unanimous,D'Amato,30,26,English,30,26,Tirelli,30,27,4,4,3
2018-11-15,3,Palancica,Medvedovsky,Palancica,Unanimous,D'Amato,29,27,English,29,27,Miner,30,26,2,2,4
2018-11-15,3,Gracie,Becker,Gracie,Unanimous,English,29,28,Miner,30,27,Tirelli,29,28,1,3,1
2018-11-15,3,Kelesh,Barbarosa,Barbarosa,Unanimous,D'Amato,27,30,English,27,30,Miner,27,30,-3,-3,-3
2018-11-15,3,Smotritsky,Levi,Smotritsky,Unanimous,D'Amato,30,27,English,29,28,Tirelli,30,27,3,1,3
2018-11-15,3,Pop,Rubinov,Rubinov,Unanimous,D'Amato,28,29,English,28,29,Tirelli,28,29,-1,-1,-1
2018-11-10,3,Pennington,de Randamie,de Randamie,Unanimous,Cleary,27,30,Lee,27,30,Ramirez,27,30,-3,-3,-3
2018-11-10,3,Dariush,Moises,Dariush,Unanimous,Cleary,30,25,D'Amato,30,25,Hilsabeck,30,26,5,5,4
2018-11-10,3,Pena,Trizano,Trizano,Split,D'Amato,29,28,Lee,28,29,Ramirez,27,30,1,-1,-3
2018-11-10,3,Cooper,Yoder,Yoder,Split,Cleary,28,29,Thrasher,28,29,Van Tine,30,27,-1,-1,3
2018-11-10,3,Shelton,Morales,Shelton,Split,Lee,29,28,Ramirez,30,27,Thrasher,27,30,1,3,-3
2018-11-10,3,De La Rosa,Sanchez,De La Rosa,Split,D'Amato,29,28,Hilsabeck,30,27,Thrasher,28,29,1,3,-1
2018-11-03,3,Roberson,Marshman,Roberson,Unanimous,Crosby,30,27,D'Amato,30,26,Lee,30,26,3,4,4
2018-11-03,3,Rinaldi,Knight,Rinaldi,Unanimous,Cleary,30,25,Crosby,30,27,D'Amato,30,26,5,3,4
2018-11-03,3,Modafferi,Eubanks,Eubanks,Unanimous,Lee,27,30,Miner,27,30,Tirelli,27,30,-3,-3,-3
2018-11-03,3,Moraes,Arce,Moraes,Split,Cleary,29,28,Crosby,30,26,Lee,28,29,1,4,-1
2018-11-03,3,de Lima,Wieczorek,de Lima,Unanimous,D'Amato,30,27,Lee,30,27,Tirelli,30,27,3,3,3
2018-11-03,3,Frevola,Vannata,draw,Majority,D'Amato,28,28,Lee,29,28,Tirelli,28,28,0,1,0
2018-10-27,3,Lobov,Johnson,Johnson,Unanimous,Arsenault,27,30,Crosby,28,29,Woods,28,29,-3,-1,-1
2018-10-27,3,Soukhamthath,Martinez,Soukhamthath,Unanimous,Crosby,29,28,Doiron,29,28,Woods,30,26,1,1,4
2018-10-27,3,Herman,Villante,Villante,Split,Earle,28,29,Leblanc,29,28,Therien,28,29,-1,1,-1
2018-10-27,3,Garcia,McGee,McGee,Unanimous,Arsenault,28,29,Crosby,28,30,Woods,28,29,-1,-2,-1
2018-10-27,3,Gouti,Haqparast,Haqparast,Unanimous,Crosby,27,29,Doiron,27,29,Woods,26,30,-2,-2,-4
2018-10-27,3,Moras,Bernardo,Bernardo,Unanimous,Arsenault,28,29,Crosby,27,30,Locke,28,29,-1,-3,-1
2018-10-27,3,Bhullar,Golm,Bhullar,Unanimous,Arsenault,29,28,Locke,29,27,Woods,29,28,1,2,1
2018-10-27,3,Ray,Ayari,Ray,Unanimous,Doiron,29,28,Earle,30,27,Leblanc,29,28,1,3,1
2018-10-20,5,Paterno,Houston,Houston,Split,Cartlidge,47,48,Collett,47,48,Lethaby,48,46,-1,-1,2
2018-10-20,3,Monarch,Trueman,Trueman,Unanimous,Cartlidge,27,30,Collett,27,30,Lethaby,27,30,-3,-3,-3
2018-10-20,3,Proctor,Rubino,Proctor,Unanimous,Cartlidge,29,28,Collett,29,28,Lethaby,29,28,1,1,1
2018-10-20,3,Jazbutis,Crawford,Crawford,Unanimous,Cartlidge,26,30,Goddard,28,29,Lethaby,27,30,-4,-1,-3
2018-10-13,3,Henderson,Awad,Henderson,Unanimous,Corrado,30,26,Porter,30,27,Varela,30,26,4,3,4
2018-10-13,3,Tokov,Shlemenko,Tokov,Unanimous,Colón,30,27,D'Amato,30,27,Varela,30,27,3,3,3
2018-10-13,3,Rodriguez,Diorio,Rodriguez,Unanimous,Colón,30,27,Porter,30,27,Varela,30,27,3,3,3
2018-10-13,3,Moore,Meshkhoradze,Meshkhoradze,Split,Colón,27,30,Lee,27,30,Varela,29,28,-3,-3,1
2018-10-13,3,Fiore,Mickle,Fiore,Unanimous,Colón,30,27,Corrado,30,27,Lee,30,27,3,3,3
2018-10-12,3,Bader,Mitrione,Bader,Unanimous,Colón,30,25,Peabody,30,25,Tirelli,30,24,5,5,6
2018-10-12,3,Larkin,Pascu,Larkin,Unanimous,Colón,29,28,Peabody,29,28,Tirelli,29,28,1,1,1
2018-10-12,3,Caron,de Jesus,de Jesus,Unanimous,Colón,28,29,Peabody,27,30,Tirelli,28,29,-1,-3,-1
2018-10-12,3,Torres,Fialho,Fialho,Majority,English,28,28,Peabody,28,29,Tirelli,28,29,0,-1,-1
2018-10-12,3,Click,Lopez,Click,Unanimous,Colón,30,27,English,30,27,Tirelli,30,27,3,3,3
2018-10-12,3,Xhema,Casey,Casey,Unanimous,Colón,26,30,Miner,26,30,Peabody,26,30,-4,-4,-4
2018-10-06,3,Saint Preux,Reyes,Reyes,Unanimous,Cleary,27,30,D'Amato,27,30,Trowbridge,27,30,-3,-3,-3
2018-10-06,3,Herrig,Waterson-Gomez,Waterson-Gomez,Unanimous,Bell,28,29,Hagen,27,30,Lee,26,30,-1,-3,-4
2018-10-06,3,Formiga,Pettis,Formiga,Unanimous,Cleary,30,26,D'Amato,29,28,Hagen,29,28,4,1,1
2018-10-06,3,Lansberg,Kunitskaya,Kunitskaya,Unanimous,Byrd,27,30,D'Amato,27,30,Rosales,27,30,-3,-3,-3
2018-10-06,3,Davis,Krakowski,Krakowski,Split,Grüner,27,29,Motylewski,28,29,Pawlega,29,28,-2,-1,1
2018-09-29,3,Abdelaziz,Anderson,Anderson,Split,Cleary,28,29,Saucedo,29,28,Vierra,28,29,-1,1,-1
2018-09-29,3,Ortiz,Ycaro,Ortiz,Unanimous,Mccarthy,30,27,Rosales,29,28,Vierra,29,28,3,1,1
2018-09-29,3,Wu,Batin-Gonzalez,Batin-Gonzalez,Split,Guingona,28,29,Mccarthy,27,29,Vierra,29,28,-1,-2,1
2018-09-29,3,Taylor Melendez,Zimmerman,Taylor Melendez,Split,Cleary,28,29,Rosales,29,28,Vierra,29,28,-1,1,1
2018-09-29,3,Terry,Piccolotti,Piccolotti,Unanimous,Cleary,27,30,Rosales,27,30,Saucedo,28,29,-3,-3,-1
2018-09-29,3,Neal,San Diego,San Diego,Split,Cleary,28,29,Guingona,27,30,Saucedo,29,28,-1,-3,1
2018-09-29,3,Ramirez,Campbell,Campbell,Unanimous,Bell,27,30,Mccarthy,27,30,Vierra,27,30,-3,-3,-3
2018-09-29,3,Romero,Figueroa,Figueroa,Unanimous,Bell,26,28,Cleary,26,29,Rosales,27,29,-2,-3,-2
2018-09-29,3,Edwards,Bouland,Bouland,Unanimous,Cartlidge,28,29,Collett,28,29,Lethaby,28,29,-1,-1,-1
2018-09-29,3,DiSegni,McKenna,DiSegni,Split,Cartlidge,29,28,Collett,27,30,Lethaby,29,28,1,-3,1
2018-09-29,3,Croxson,Corston,Croxson,Unanimous,Cartlidge,29,27,Collett,30,26,Lethaby,30,26,2,4,4
2018-09-29,3,Jenkins,Shanks,Shanks,Unanimous,Cartlidge,27,30,Collett,27,30,Lethaby,27,30,-3,-3,-3
2018-09-22,3,Barão,Ewell,Ewell,Split,Cleary,28,29,Pontes,28,29,Vilhena,29,28,-1,-1,1
2018-09-22,3,Henrique,Spann,Spann,Unanimous,Lee,27,30,Pontes,28,29,Vilhena,27,30,-3,-1,-3
2018-09-22,3,Lombard,Leites,Leites,Unanimous,Bravo,28,29,Lee,28,29,Pontes,28,29,-1,-1,-1
2018-09-22,3,Markos,Rodriguez,draw,Majority,Cleary,28,28,Lee,29,28,Pontes,28,28,0,1,0
2018-09-21,3,Morales,Hugo,Morales,Unanimous,Marker,29,27,Mccarthy,30,27,Turner,30,25,2,3,5
2018-09-21,3,Powers,Trice,Trice,Split,Bell,29,28,Marker,28,29,Miner,28,29,1,-1,-1
2018-09-15,12,Golovkin,Álvarez,Álvarez,Majority,Feldman,114,114,Moretti,113,115,Weisfeld,113,115,0,-2,-2
2018-09-15,3,Arlovski,Abdurakhimov,Abdurakhimov,Unanimous,Cartlidge,27,30,Cleary,27,30,Makhmutova,28,29,-3,-3,-1
2018-09-15,3,Yan,Son,Yan,Unanimous,Cleary,30,27,Collett,29,28,Harasim,30,27,3,1,3
2018-09-15,3,Khabilov,Johnson,Khabilov,Split,Cartlidge,29,28,Lethaby,28,29,Motylewski,29,28,1,-1,1
2018-09-15,3,Green,Taisumov,Taisumov,Unanimous,Cleary,27,30,Collett,27,30,Harasim,27,30,-3,-3,-3
2018-09-15,3,Emeev,Sekulic,Emeev,Unanimous,Bosacki,30,27,Cleary,30,26,Makhmutova,29,28,3,4,1
2018-09-15,3,Ware,Dvalishvili,Dvalishvili,Unanimous,Cartlidge,25,30,Lethaby,25,30,Motylewski,25,30,-5,-5,-5
2018-09-08,3,Dodson,Rivera,Rivera,Unanimous,Armstrong,27,30,Lee,27,30,Martinez,28,29,-3,-3,-1
2018-09-08,3,White,Sanchez,Sanchez,Unanimous,Armstrong,27,30,Martinez,27,30,Mathisen,27,30,-3,-3,-3
2018-09-08,3,Pudilova,Aldana,Aldana,Split,Armstrong,28,29,Lee,28,29,Turnage,29,28,-1,-1,1
2018-09-08,3,Sanchez,Brooks,Brooks,Split,Armstrong,28,29,Lee,28,29,Turnage,29,28,-1,-1,1
2018-09-01,5,Bak,Pimblett,Bak,Unanimous,Cartlidge,48,44,Collett,48,45,Lethaby,48,46,4,3,2
2018-09-01,3,Bonner,Barnett,draw,Majority,Cartlidge,28,28,Collett,27,28,Lethaby,28,28,0,-1,0
2018-08-25,3,Johnson,Fili,Johnson,Split,D'Amato,29,28,Gynan,27,30,Trowbridge,29,28,1,-3,1
2018-08-25,3,Hill,Casey,Casey,Split,D'Amato,28,29,Prieto,29,28,Trowbridge,27,30,-1,1,-3
2018-08-25,3,Sanchez,Perez,Sanchez,Unanimous,D'Amato,29,28,Prieto,29,28,Trowbridge,29,28,1,1,1
2018-08-25,3,Dober,Tuck,Dober,Unanimous,Cleary,30,26,D'Amato,30,26,Prieto,30,27,4,4,3
2018-08-17,3,Lencioni,Claxton,Claxton,Unanimous,D'Amato,26,30,Johnson,27,30,Wichgers,27,30,-4,-3,-3
2018-08-17,3,Logan,Jackson,Jackson,Split,Bell,28,29,Johnson,27,30,Ruml,29,28,-1,-3,1
2018-08-17,3,Phathaem,Peatrowsky,Phathaem,Unanimous,Colón,30,27,Johnson,29,28,Wichgers,30,27,3,1,3
2018-08-04,5,Johnson,Cejudo,Cejudo,Split,D'Amato,47,48,Mccarthy,47,48,Rosales,48,47,-1,-1,1
2018-08-04,3,Aldrich,Viana,Aldrich,Unanimous,D'Amato,29,28,Mccarthy,30,27,Rosales,29,28,1,3,1
2018-08-04,3,Holland,Santos,Santos,Unanimous,Bell,27,29,Bravo,26,29,Cleary,27,29,-2,-3,-2
2018-08-04,3,Munhoz,Johns,Munhoz,Unanimous,D'Amato,30,26,Mccarthy,29,28,Rosales,29,27,4,1,2
2018-08-04,3,Jackson,Simon,Simon,Unanimous,Bell,28,29,Cleary,27,30,Rosales,27,30,-1,-3,-3
2018-08-04,3,Kang,Ramos,Ramos,Split,Cleary,29,28,D'Amato,28,29,Rosales,28,29,1,-1,-1
2018-08-04,3,Moraes,Sayles,Moraes,Unanimous,Bravo,29,28,D'Amato,29,28,Mccarthy,29,28,1,1,1
2018-08-04,3,Taylor,Zhang,Zhang,Unanimous,Bravo,28,29,D'Amato,28,29,Mccarthy,28,29,-1,-1,-1
2018-07-28,3,Jedrzejczyk,Torres,Jedrzejczyk,Unanimous,D'Amato,30,27,Rodgers,30,27,Weeks,30,27,3,3,3
2018-07-28,3,Hernandez,Aubin-Mercier,Hernandez,Unanimous,Cleary,29,28,Jackson,30,27,Lee,29,28,1,3,1
2018-07-28,3,Morono,Mein,Mein,Unanimous,Cleary,28,29,Jackson,28,29,Lee,28,29,-1,-1,-1
2018-07-28,3,Dawodu,Arnett,Dawodu,Unanimous,D'Amato,30,27,Rodgers,30,27,Weeks,30,27,3,3,3
2018-07-28,3,Makdessi,Pearson,Makdessi,Unanimous,Cleary,30,26,Jackson,29,28,Lee,29,27,4,1,2
2018-07-28,3,Chookagian,Davis,Chookagian,Unanimous,D'Amato,29,28,Rodgers,30,27,Weeks,29,28,1,3,1
2018-07-28,3,Nunes,Markos,Nunes,Unanimous,D'Amato,29,28,Rodgers,29,28,Weeks,29,28,1,1,1
2018-07-22,3,Teixeira,Anderson,Anderson,Unanimous,Cartlidge,27,30,Harasim,27,30,Hughes,27,30,-3,-3,-3
2018-07-22,3,Miranda,Azaitar,Azaitar,Unanimous,Grüner,27,30,Kobayashi,27,30,Lethaby,28,29,-3,-3,-1
2018-07-22,3,Tybura,Struve,Tybura,Unanimous,Collett,30,27,Grüner,30,27,Harasim,29,28,3,3,1
2018-07-22,3,Zawada,Roberts,Roberts,Split,Cartlidge,28,29,Hughes,28,29,Kobayashi,30,27,-1,-1,3
2018-07-22,3,Diakiese,Haqparast,Haqparast,Unanimous,Collett,27,30,Grüner,27,30,Lethaby,26,30,-3,-3,-4
2018-07-22,3,Hadzovic,Hein,Hadzovic,Split,Cartlidge,29,28,Harasim,29,28,Hughes,28,29,1,1,-1
2018-07-22,3,Meek,Fabinski,Fabinski,Unanimous,Collett,27,30,Kobayashi,28,29,Lethaby,28,29,-3,-1,-1
2018-07-22,3,Taha,Narimani,Narimani,Unanimous,Cartlidge,27,30,Grüner,27,30,Harasim,27,30,-3,-3,-3
2018-07-22,3,Ledet,Rakic,Rakic,Unanimous,Hughes,24,30,Kobayashi,24,30,Lethaby,25,30,-6,-6,-5
2018-07-22,3,Stasiak,Pingyuan,Pingyuan,Unanimous,Collett,27,30,Grüner,28,29,Lethaby,28,29,-3,-1,-1
2018-07-21,5,Frey,Grusander,Frey,Unanimous,Gueary,48,47,Marquez,49,46,Swanberg,48,47,1,3,1
2018-07-21,3,Zappitella,DeCoursey,Zappitella,Unanimous,Gueary,30,27,Marquez,30,27,Swanberg,30,27,3,3,3
2018-07-21,3,Cloudy,Blanchfield,Blanchfield,Split,Gueary,28,29,Marquez,28,29,Swanberg,29,28,-1,-1,1
2018-07-21,3,Arthur,Ekundayo,Ekundayo,Unanimous,Cartlidge,26,30,Lethaby,26,30,Ransom,26,30,-4,-4,-4
2018-07-21,3,Deh,Jones,Jones,Unanimous,Cartlidge,27,30,Lethaby,27,30,Ransom,27,30,-3,-3,-3
2018-07-21,3,McBain,Aimable,McBain,Unanimous,Cartlidge,30,27,Lethaby,30,27,Ransom,30,27,3,3,3
2018-07-21,3,Wells,Iwanowski,Wells,Split,Cartlidge,29,28,Lethaby,29,28,Ransom,28,29,1,1,-1
2018-07-21,3,Edwards,Iovine,Edwards,Unanimous,Cartlidge,29,25,Lethaby,28,26,Ransom,28,26,4,2,2
2018-07-14,5,dos Santos,Ivanov,dos Santos,Unanimous,Hagen,50,45,Turner,50,45,Weeks,50,45,5,5,5
2018-07-14,3,Glenn,Bermudez,Glenn,Split,Mikkelson,30,27,Turner,28,29,Weeks,29,28,3,-1,1
2018-07-14,3,Reneau,Zingano,Zingano,Unanimous,Hagen,27,30,Turner,27,30,Weeks,26,30,-3,-3,-4
2018-07-14,3,Wineland,Perez,Perez,Unanimous,Hagen,28,29,Mikkelson,28,29,Weeks,28,29,-1,-1,-1
2018-07-14,3,Volkanovski,Elkins,Volkanovski,Unanimous,Marker,29,28,Rosales,29,28,Turner,30,27,1,1,3
2018-07-14,3,Scoggins,Nurmagomedov,Nurmagomedov,Split,Hagen,28,29,Mikkelson,29,28,Rosales,28,29,-1,1,-1
2018-07-14,3,Maia,Carmouche,Carmouche,Unanimous,Hagen,28,29,Marker,27,30,Rosales,27,30,-1,-3,-3
2018-07-14,5,Freire,Weichel,Freire,Split,Cleary,47,48,D'Amato,49,46,Lee,48,47,-1,3,1
2018-07-13,3,Honeycutt,Leite,Honeycutt,Unanimous,Mathisen,30,25,Sutherland,30,25,Turnage,30,25,5,5,5
2018-07-13,3,Williams,Morris,Morris,Unanimous,Mathisen,25,30,Sutherland,27,30,Tallchief,26,30,-5,-3,-4
2018-07-13,3,Harris,Amosov,Amosov,Unanimous,Mathisen,27,30,Tallchief,27,30,Turnage,26,30,-3,-3,-4
2018-07-07,3,Lewis,Ngannou,Lewis,Unanimous,Cleary,29,28,D'Amato,30,27,Kamijo,29,28,1,3,1
2018-07-07,3,Perry,Felder,Perry,Split,Bell,29,28,Hagen,28,29,Lee,29,28,1,-1,1
2018-07-07,3,Assuncao,Font,Assuncao,Unanimous,Bell,30,27,Hagen,30,27,Winter,30,27,3,3,3
2018-07-07,3,Klose,Vannata,Klose,Unanimous,Byrd,30,27,D'Amato,30,27,Kamijo,30,27,3,3,3
2018-07-07,3,Griffin,Millender,Millender,Unanimous,Cleary,28,29,Hagen,28,29,Winter,28,29,-1,-1,-1
2018-07-07,3,Moyle,Whitmire,Whitmire,Unanimous,Kamijo,28,29,Lee,28,29,Winter,28,29,-1,-1,-1
2018-07-06,5,Adesanya,Tavares,Adesanya,Unanimous,Cleary,50,45,D'Amato,50,45,Lee,49,46,5,5,3
2018-07-06,3,Trizano,Giannetti,Trizano,Split,Hagen,29,28,Kamijo,29,28,Trowbridge,28,29,1,1,-1
2018-07-06,3,Cucciniello,Katona,Katona,Unanimous,Bell,26,30,Byrd,26,30,D'Amato,26,30,-4,-4,-4
2018-07-06,3,Bravo,Caceres,Caceres,Split,Cleary,28,29,Hagen,28,29,Winter,29,28,-1,-1,1
2018-07-06,3,Di Chirico,Marquez,Di Chirico,Split,Byrd,29,28,D'Amato,29,28,Hagen,27,30,1,1,-3
2018-07-06,3,Zuniga,Gunther,Gunther,Majority,Byrd,28,29,D'Amato,28,29,Hagen,28,28,-1,-1,0
2018-07-06,3,Mitchell,Diamond,Mitchell,Majority,Bell,28,28,Cleary,29,28,Winter,29,28,0,1,1
2018-07-06,3,Peterson,Bessette,Peterson,Split,Kamijo,29,28,Lee,28,29,Trowbridge,29,28,1,-1,1
2018-06-29,3,Létourneau,Williams,Létourneau,Unanimous,Bell,29,28,Denkin,29,28,Rosales,29,28,1,1,1
2018-06-29,3,Davis,Plaskett,Davis,Unanimous,Cobian,30,26,Denkin,30,26,Rosales,30,26,4,4,4
2018-06-23,5,Edwards,Cerrone,Edwards,Unanimous,Booth,48,47,Field,48,47,Keech,48,47,1,1,1
2018-06-23,3,Eye,Clark,Eye,Unanimous,Booth,29,28,Keech,29,28,Shen,30,27,1,1,3
2018-06-23,3,Jingliang,Abe,Jingliang,Unanimous,Cartlidge,30,26,Craig,30,27,Field,30,27,4,3,3
2018-06-23,3,Xiaonan,Pereira,Xiaonan,Unanimous,Booth,29,28,Craig,30,27,Shen,29,28,1,3,1
2018-06-23,3,Schnell,Inoue,Schnell,Split,Field,29,28,Harriman,28,29,Keech,29,28,1,-1,1
2018-06-23,3,Kim,Fabian,Kim,Split,Cartlidge,29,28,Harriman,29,28,Keech,28,29,1,1,-1
2018-06-16,3,Herbert,Karatas,Herbert,Unanimous,Cartlidge,29,27,Collett,29,28,Lethaby,30,27,2,1,3
2018-06-16,3,Alekozai,Klaczek,Klaczek,Unanimous,Cartlidge,26,30,Collett,24,30,Lethaby,26,30,-4,-6,-4
2018-06-16,3,McKenna,Dourthe,McKenna,Split,Cartlidge,29,28,Collett,28,29,Lethaby,29,28,1,-1,1
2018-06-16,3,McCourt,Fiorot,McCourt,Split,Cartlidge,27,30,Collett,29,28,Lethaby,30,27,-3,1,3
2018-06-09,3,Torres,Wolanski,Torres,Split,Kloc,28,29,Pawlega,29,28,Porebski,29,28,-1,1,1
2018-06-09,5,Romero,Whittaker,Whittaker,Split,D'Amato,48,47,Lee,47,48,Puccillo,47,48,1,-1,-1
2018-06-09,5,Covington,dos Anjos,Covington,Unanimous,Bell,48,47,Caldwell,48,47,D'Amato,49,46,1,1,3
2018-06-09,3,Anderson,Holm,Holm,Unanimous,Bell,26,30,Caldwell,26,30,Puccillo,27,30,-4,-4,-3
2018-06-09,3,Tuivasa,Arlovski,Tuivasa,Unanimous,Lee,29,28,Mason,29,28,Puccillo,29,28,1,1,1
2018-06-09,3,Jackson,Punk,Jackson,Unanimous,D'Amato,30,26,Lee,30,26,Mason,30,26,4,4,4
2018-06-09,3,Esparza,Gadelha,Gadelha,Split,Bell,28,29,Caldwell,29,28,Puccillo,28,29,-1,1,-1
2018-06-09,3,Lamas,Bektic,Bektic,Split,D'Amato,29,28,Lee,28,29,Mason,27,30,1,-1,-3
2018-06-09,3,Pettis,Benavidez,Pettis,Split,Bell,29,28,Caldwell,30,27,Puccillo,28,29,1,3,-1
2018-06-01,3,Alvey,Villante,Alvey,Split,Colón,29,28,Corrado,28,29,Tirelli,29,28,1,-1,1
2018-06-01,3,Murphy,Eubanks,Eubanks,Unanimous,Cleary,27,30,Crosby,28,29,D'Amato,27,30,-3,-1,-3
2018-06-01,3,Lentz,Teymur,Teymur,Unanimous,Colón,27,30,Corrado,27,30,Crosby,28,29,-3,-3,-1
2018-06-01,3,Muhammad,Rencountre,Muhammad,Unanimous,Cleary,30,27,D'Amato,30,27,Tirelli,30,27,3,3,3
2018-06-01,3,Tibau,Green,Green,Unanimous,Colón,27,30,Corrado,27,30,D'Amato,27,29,-3,-3,-2
2018-05-27,5,Till,Thompson,Till,Unanimous,Collett,48,47,Roberts,49,46,Sutherland,49,46,1,3,3
2018-05-27,3,Amirkhani,Knight,Amirkhani,Split,Collett,29,28,Hughes,29,28,Roberts,27,30,1,1,-3
2018-05-27,3,Lansberg,Mazany,Lansberg,Unanimous,Collett,29,28,Hughes,30,27,Roberts,30,27,1,3,3
2018-05-27,3,Scott,Pedersoli Jr.,Pedersoli Jr.,Split,Hughes,28,29,Roberts,28,29,Sutherland,29,28,-1,-1,1
2018-05-27,3,Smith,Theodorou,Theodorou,Unanimous,Cartlidge,27,30,Lethaby,27,30,Sutherland,28,29,-3,-3,-1
2018-05-25,3,Yankova,Jackson,Jackson,Unanimous,Colón,26,30,Crosby,27,29,D'Amato,26,30,-4,-2,-4
2018-05-25,3,Carvalho,Crawford,Carvalho,Split,Colón,28,29,Crosby,29,28,D'Amato,29,28,-1,1,1
2018-05-19,5,Maia,Usman,Usman,Unanimous,Bravo,46,49,D'Amato,46,49,Lee,45,50,-3,-3,-5
2018-05-19,3,Cannetti,Rivas,Cannetti,Unanimous,Alves,29,28,Bertrand,29,28,Lee,29,28,1,1,1
2018-05-19,3,Lee,Macedo,Lee,Unanimous,Bravo,30,27,D'Amato,30,27,Vilhena,30,27,3,3,3
2018-05-19,3,Prazeres,Cummings,Prazeres,Split,Alves,29,28,Lee,28,29,Vilhena,29,28,1,-1,1
2018-05-19,3,Moreno,Pantoja,Pantoja,Unanimous,Bertrand,27,29,Lee,26,30,Vilhena,26,30,-2,-4,-4
2018-05-19,3,Davis,Barzola,Barzola,Unanimous,Bravo,26,30,Lee,26,30,Vilhena,27,30,-4,-4,-3
2018-05-19,3,Saenz,Briones,Saenz,Unanimous,Alves,30,26,Bertrand,30,27,D'Amato,30,27,4,3,3
2018-05-12,3,Fitch,Daley,Fitch,Unanimous,Bell,29,26,Mccarthy,29,27,Rosales,29,26,3,2,3
2018-05-12,3,Harding,Leibrock,Leibrock,Unanimous,Bell,27,30,Saucedo,26,30,Vierra,26,30,-3,-4,-4
2018-05-12,3,Mohammed,Terry,Terry,Unanimous,Guingona,26,30,Mccarthy,26,30,Rosales,26,30,-4,-4,-4
2018-05-12,3,Souza,Gastelum,Gastelum,Split,Bravo,28,29,D'Amato,29,28,Lee,28,29,-1,1,-1
2018-05-12,3,Mina,Emeev,Emeev,Unanimous,Alves,27,30,Cleary,27,30,D'Amato,27,30,-3,-3,-3
2018-05-04,3,Daimoni,Kianzad,Kianzad,Unanimous,Gueary,27,30,Marquez,27,30,Swanberg,27,30,-3,-3,-3
2018-05-04,3,Tracy,Muraski,Tracy,Unanimous,Gueary,29,28,Marquez,30,27,Swanberg,30,27,1,3,3
2018-05-04,3,Verzosa,Kleczka,Verzosa,Unanimous,Gueary,29,28,Marquez,29,28,Swanberg,29,28,1,1,1
2018-05-04,3,Schmidt,Chiasson,Chiasson,Unanimous,Gueary,27,30,Marquez,27,30,Swanberg,27,30,-3,-3,-3
2018-05-04,3,Vlismas,Peralta,Peralta,Unanimous,Gueary,28,29,Marquez,28,29,Swanberg,27,30,-1,-1,-3
2018-04-28,3,Dalby,Pedersoli Jr.,Pedersoli Jr.,Split,Agneby,28,29,Grüner,27,29,Ohlsson,29,28,-1,-2,1
2018-04-28,3,Carlos,Paraisy,Carlos,Unanimous,Agneby,30,27,Grüner,30,27,Gustafsson,29,28,3,3,1
2018-04-28,3,Grant,Dakaev,Grant,Unanimous,Agneby,30,27,Gustafsson,30,27,Ohlsson,30,26,3,3,4
2018-04-28,3,Hermansson,Holm,Hermansson,Split,Agneby,28,29,Gustafsson,29,28,Ohlsson,29,28,-1,1,1
2018-04-28,3,Macedo,Goodwin,Macedo,Unanimous,Agneby,30,27,Gustafsson,29,28,Ohlsson,30,27,3,1,3
2018-04-28,3,Franklin,D'Ambrosio,Franklin,Unanimous,Grüner,29,28,Mitchell,29,28,Ohlsson,29,28,1,1,1
2018-04-21,3,Edgar,Swanson,Edgar,Unanimous,Cleary,30,27,Colón,30,27,Urso,30,27,3,3,3
2018-04-21,3,Willis,Sherman,Willis,Unanimous,Bilyk,29,28,Carolei,29,28,Holland,29,28,1,1,1
2018-04-21,3,Sterling,Johns,Sterling,Unanimous,Cleary,30,27,Tirelli,30,27,Urso,30,27,3,3,3
2018-04-21,3,Garcia,LaFlare,LaFlare,Unanimous,Bilyk,27,30,Carolei,27,30,Urso,27,30,-3,-3,-3
2018-04-21,3,Anderson,Cummins,Anderson,Unanimous,Bilyk,30,26,Carolei,30,26,Urso,30,27,4,4,3
2018-04-21,3,Martin,Nakamura,Martin,Unanimous,Bilyk,30,27,Holland,30,27,Tirelli,30,27,3,3,3
2018-04-14,3,Adesanya,Vettori,Adesanya,Split,Cleary,29,28,Hayes,29,28,Lee,28,29,1,1,-1
2018-04-14,3,Casey,Waterson-Gomez,Waterson-Gomez,Split,D'Amato,29,28,Flores,28,29,Hagen,28,29,1,-1,-1
2018-04-14,3,Moraga,Reis,Moraga,Unanimous,D'Amato,29,28,Flores,29,28,Lee,29,28,1,1,1
2018-04-14,3,Dobson,Mueller,Mueller,Unanimous,Cleary,28,29,Flores,28,29,Hagen,28,29,-1,-1,-1
2018-04-14,3,Okami,Lima,Okami,Unanimous,D'Amato,30,26,Frank,30,26,Lee,30,26,4,4,4
2018-04-14,3,Williams,Sanders,Sanders,Unanimous,Cleary,28,29,Frank,27,30,Lee,27,30,-1,-3,-3
2018-04-14,3,Parnasse,Sowinski,Parnasse,Unanimous,Bonkowski,30,27,Novak,30,27,Wojciechowski,30,27,3,3,3
2018-04-14,3,Parke,Chlewicki,Parke,Unanimous,Cartlidge,30,26,Grüner,30,26,Porebski,30,25,4,4,5
2018-04-14,3,Selwa,Racic,Racic,Unanimous,Bonkowski,28,29,Kloc,27,30,Porebski,27,30,-1,-3,-3
2018-04-14,3,Kalicinski,Kazieczko,Kazieczko,Unanimous,Cartlidge,27,30,Kloc,27,30,Wojciechowski,27,30,-3,-3,-3
2018-04-13,3,Buckley,Storley,Storley,Unanimous,D'Amato,26,30,Francis,27,30,Lee,26,30,-4,-3,-4
2018-04-13,3,Bucia,Anderson,Anderson,Unanimous,Buesking,27,30,D'Amato,27,30,Lee,27,30,-3,-3,-3
2018-04-07,5,Nurmagomedov,Iaquinta,Nurmagomedov,Unanimous,Cleary,50,44,D'Amato,50,43,Lee,50,43,6,7,7
2018-04-07,5,Namajunas,Jedrzejczyk,Namajunas,Unanimous,Lee,49,46,Tirelli,49,46,Trowbridge,49,46,3,3,3
2018-04-07,3,Moicano,Kattar,Moicano,Unanimous,D'Amato,29,28,Tirelli,30,27,Trowbridge,30,27,1,3,3
2018-04-07,3,Magomedsharipov,Bochniak,Magomedsharipov,Unanimous,Cleary,30,27,Lee,30,27,Trowbridge,29,28,3,3,1
2018-04-07,3,Kowalkiewicz,Herrig,Kowalkiewicz,Split,Cleary,29,28,D'Amato,29,28,Lee,28,29,1,1,-1
2018-04-07,3,Rawlings,Evans-Smith,Evans-Smith,Unanimous,Bruce,27,30,Lee,27,30,Tirelli,27,30,-3,-3,-3
2018-04-07,3,Rodriguez,Clark,Clark,Unanimous,Cleary,27,30,D'Amato,27,30,Trowbridge,28,29,-3,-3,-1
2018-04-06,3,Kielholtz,Castkova,Kielholtz,Unanimous,Colón,30,27,Crosby,30,27,Miner,30,27,3,3,3
2018-04-06,3,Pascu,Ruth,Ruth,Unanimous,Colón,27,30,Crosby,28,29,Miner,27,30,-3,-1,-3
2018-03-24,5,Inoue,Jandiroba,Jandiroba,Split,Furse,46,49,Montanez,46,49,Montanez,49,46,-3,-3,3
2018-03-24,3,Bennett,Rodriguez,Bennett,Split,Furse,30,27,Montanez,30,27,Montanez,27,30,3,3,-3
2018-03-24,3,Gonzalez,Robbins,Gonzalez,Unanimous,Dutcher,30,27,Furse,30,26,Montanez,30,27,3,4,3
2018-03-24,3,Kenneson,Chandler,Kenneson,Unanimous,Dutcher,30,27,Furse,30,27,Montanez,30,27,3,3,3
2018-03-24,3,DeCoursey,LeVine,DeCoursey,Unanimous,Dutcher,30,27,Furse,30,27,Montanez,30,27,3,3,3
2018-03-24,3,Neil,Cortez,Cortez,Unanimous,Dutcher,27,30,Furse,27,30,Montanez,27,30,-3,-3,-3
2018-03-24,3,Shore,Lee,Shore,Unanimous,Cartlidge,29,28,Collett,30,27,Lethaby,30,27,1,3,3
2018-03-24,3,Trueman,Eaton,Trueman,Unanimous,Cartlidge,29,27,Collett,30,27,Lethaby,29,28,2,3,1
2018-03-24,3,Richardson,Boult,Boult,Unanimous,Cartlidge,27,30,Collett,27,30,Lethaby,27,30,-3,-3,-3
2018-03-24,3,Lee,Mearns,Lee,Unanimous,Cartlidge,29,28,Collett,29,28,Lethaby,29,28,1,1,1
2018-03-17,3,Blachowicz,Manuwa,Blachowicz,Unanimous,Hughes,29,28,Lethaby,30,27,Motylewski,29,28,1,3,1
2018-03-17,3,Ware,Duquesnoy,Duquesnoy,Unanimous,Cartlidge,27,30,Lethaby,28,29,Motylewski,28,29,-3,-1,-1
2018-03-17,3,Ray,Johnson,Johnson,Split,Lethaby,28,29,Roberts,28,29,Sutherland,29,28,-1,-1,1
2018-03-03,3,Soukhamthath,O'Malley,O'Malley,Unanimous,D'Amato,28,29,Kamijo,27,29,Lee,27,29,-1,-2,-2
2018-03-03,3,Arlovski,Struve,Arlovski,Unanimous,Cleary,29,28,Trowbridge,30,27,Weeks,29,28,1,3,1
2018-03-03,3,Zingano,Vieira,Vieira,Split,D'Amato,28,29,Hagen,28,29,Rosales,29,28,-1,-1,1
2018-03-03,3,Yoder,Dern,Dern,Split,Byrd,29,28,Cleary,28,29,Kamijo,28,29,1,-1,-1
2018-03-03,3,Munhoz,Dodson,Dodson,Split,Byrd,27,30,D'Amato,29,28,Trowbridge,28,29,-3,1,-1
2018-03-03,3,Stamann,Caraway,Stamann,Split,Byrd,29,28,D'Amato,29,28,Trowbridge,28,29,1,1,-1
2018-03-03,3,Johnson,Milstead,Johnson,Split,Lee,29,28,Rosales,27,30,Weeks,29,28,1,-3,1
2018-03-03,5,Gomez Juarez,Lipski,Lipski,Unanimous,Motylewski,46,49,Novak,46,49,Pawlega,46,49,-3,-3,-3
2018-03-03,3,Kopera,Wolanski,Wolanski,Unanimous,Lethaby,27,30,Motylewski,26,30,Novak,27,30,-3,-4,-3
2018-03-03,3,Houston,Khalid,Houston,Unanimous,Collett,30,25,Johnson,30,26,Mitchell,30,27,5,4,3
2018-03-03,3,Jenkins,Malone,Malone,Unanimous,Collett,26,30,Johnson,27,30,Mitchell,27,30,-4,-3,-3
2018-03-02,3,Warren,Taimanglo,Taimanglo,Split,Bell,27,30,Mathisen,29,28,Sutherland,27,30,-3,1,-3
2018-03-02,3,Ducote,Williams,Williams,Split,Bell,28,29,Colón,30,27,Mathisen,28,29,-1,3,-1
2018-03-02,3,Archuleta,Joplin,Archuleta,Unanimous,Colón,30,24,Mathisen,30,23,Sutherland,30,26,6,7,4
2018-03-02,3,Carey,Lencioni,Carey,Unanimous,Bell,29,28,Mathisen,29,28,Sutherland,29,28,1,1,1
2018-02-24,3,Torres,Andrade,Andrade,Unanimous,Colón,27,29,Tirelli,28,29,Vannatta,28,29,-2,-1,-1
2018-02-24,3,Perry,Griffin,Griffin,Unanimous,Colón,27,30,Lee,27,29,Tirelli,27,29,-3,-2,-2
2018-02-24,3,Kelleher,Barão,Kelleher,Unanimous,Bertrand,30,27,Gomez,30,27,Vannatta,29,28,3,3,1
2018-02-24,3,Hill,Moroz,Hill,Unanimous,Colón,30,27,Lee,30,27,Tirelli,30,27,3,3,3
2018-02-24,3,Perez,Shelton,Perez,Unanimous,Bertrand,30,27,Silbert,30,27,Tirelli,30,27,3,3,3
2018-02-24,3,Kinsella,Tricomitis,Tricomitis,Split,Cartlidge,29,28,Collett,27,30,Lethaby,28,29,1,-3,-1
2018-02-18,3,Trinaldo,Vick,Vick,Unanimous,Lee,28,29,Rosales,28,29,Wright,28,29,-1,-1,-1
2018-02-18,3,Davis,Peterson,Davis,Unanimous,Rosales,30,27,Townsend,30,26,Wright,29,28,3,4,1
2018-02-18,3,Northcutt,Gouti,Northcutt,Unanimous,Lee,29,28,Rosales,29,28,Stafin,29,28,1,1,1
2018-02-18,3,Pudilova,Moras,Pudilova,Unanimous,Cardenas,29,28,Stafin,29,28,Townsend,29,27,1,1,2
2018-02-16,3,Nelson,Mitrione,Mitrione,Majority,Colón,28,29,Peabody,28,29,Tirelli,28,28,-1,-1,0
2018-02-16,3,Julaton,Hardy,Hardy,Unanimous,Crosby,27,30,Miner,27,30,Peabody,28,29,-3,-3,-1
2018-02-16,3,Trice,Howard,Trice,Majority,Colón,28,28,Peabody,29,27,Tirelli,29,27,0,2,2
2018-02-10,3,Blaydes,Hunt,Blaydes,Unanimous,Booth,29,27,Field,30,26,Metcalf,30,26,2,4,4
2018-02-10,3,Matthews,Jingliang,Matthews,Unanimous,Booth,30,26,Foley,30,26,Metcalf,29,28,4,4,1
2018-02-10,3,Ma,Brown,Ma,Split,Field,29,28,Foley,28,29,Metcalf,29,28,1,-1,1
2018-02-10,3,Hirota,Pearson,Pearson,Unanimous,Booth,28,29,Field,27,30,Keech,27,30,-1,-3,-3
2018-02-10,3,Quinonez,Ishihara,Quinonez,Unanimous,Booth,30,27,Collett,29,28,Foley,29,28,3,1,1
2018-02-10,3,Abe,Jumeau,Jumeau,Unanimous,Dimitriou,27,29,Keech,27,28,Metcalf,28,29,-2,-1,-1
2018-02-03,5,Anders,Machida,Machida,Split,Bravo,47,48,Rosales,48,47,Weeks,46,49,-1,1,-3
2018-02-03,3,Prazeres,Green,Prazeres,Unanimous,Bravo,30,27,Iorio,29,28,Weeks,29,28,3,1,1
2018-02-03,3,Johnson,Golm,Johnson,Unanimous,Iorio,30,27,Rosales,29,28,Terrell,29,28,3,1,1
2018-02-03,3,Silva de Andrade,Vera,Silva de Andrade,Unanimous,Bravo,30,27,Terrell,30,27,Weeks,30,27,3,3,3
2018-02-03,3,Means,Moraes,Moraes,Split,Iorio,28,29,Rosales,29,28,Weeks,28,29,-1,1,-1
2018-02-03,3,Patrick,Hadzovic,Patrick,Unanimous,Bravo,30,25,Iorio,30,27,Terrell,30,27,5,3,3
2018-01-27,3,Fili,Bermudez,Fili,Split,Claudio,29,28,Cleary,29,28,Elliott,27,30,1,1,-3
2018-01-27,3,Dober,Camacho,Dober,Unanimous,Cleary,29,28,Hopper Jr.,29,28,Silbert,30,27,1,1,3
2018-01-27,3,Green,Koch,Green,Unanimous,D'Amato,29,28,Elliott,29,28,Urso,29,28,1,1,1
2018-01-27,3,Chookagian,Romero Borella,Chookagian,Unanimous,Claudio,29,28,D'Amato,29,28,Urso,30,27,1,1,3
2018-01-27,3,Lima,Markos,Markos,Unanimous,Cleary,27,30,Hopper Jr.,27,30,Silbert,27,30,-3,-3,-3
2018-01-27,3,Kish,Kim,Kim,Split,D'Amato,29,28,Elliott,27,30,Urso,28,29,1,-3,-1
2018-01-27,3,Silva,Pichel,Pichel,Unanimous,Claudio,28,29,Cleary,28,29,Hopper Jr.,28,29,-1,-1,-1
2018-01-26,3,Aguilera,Andaya,Andaya,Unanimous,Bell,27,30,Beltran,27,30,Rathgeber,28,29,-3,-3,-1
2018-01-26,3,Lawrence,Natividad,Lawrence,Unanimous,Bell,30,27,Cobian,30,27,Mccarthy,30,27,3,3,3
2018-01-26,3,Gonzalez,Larkin,Larkin,Unanimous,Bell,28,29,Beltran,27,30,Mccarthy,27,30,-1,-3,-3
2018-01-26,3,Ambrose,Awad,Awad,Unanimous,Bell,27,30,Denkin,27,30,Mccarthy,27,30,-3,-3,-3
2018-01-26,3,Matthews,Grove,Matthews,Split,Bell,29,28,Cobian,30,27,Mccarthy,28,29,1,3,-1
2018-01-26,3,Fortune,Hernandez,Fortune,Unanimous,Beltran,30,26,Cobian,30,26,Rathgeber,30,26,4,4,4
2018-01-26,3,Fortune,Quintero,Fortune,Unanimous,Bell,29,28,Denkin,29,28,Mccarthy,29,28,1,1,1
2018-01-20,5,Ngannou,Miocic,Miocic,Unanimous,Crosby,44,50,Ginsberg,44,50,Lee,44,50,-6,-6,-6
2018-01-20,3,Villante,Barroso,Villante,Split,Ginsberg,30,27,Mena,30,27,Tirelli,28,29,3,3,-1
2018-01-20,3,Davis,Bochniak,Bochniak,Unanimous,Crosby,27,30,D'Amato,28,29,Tirelli,28,29,-3,-1,-1
2018-01-20,3,Ortiz,Pantoja,Ortiz,Unanimous,Lee,29,28,Mahmood,29,28,Mena,29,28,1,1,1
2018-01-20,3,Arce,Ige,Arce,Unanimous,Crosby,30,27,D'Amato,30,27,Phoenix,29,28,3,3,1
2018-01-20,3,Barzola,Bessette,Barzola,Unanimous,Crosby,29,28,Ginsberg,30,27,Mena,29,28,1,3,1
2018-01-20,3,Duran,Estrada,Estrada,Unanimous,Bell,28,29,Mccarthy,28,29,Miner,28,29,-1,-1,-1
2018-01-20,3,Sonnen,Jackson,Sonnen,Unanimous,Bell,29,28,Mccarthy,29,28,Miner,29,28,1,1,1
2018-01-20,5,Lima,MacDonald,MacDonald,Unanimous,Bell,45,49,Miner,47,48,Rosales,46,49,-4,-1,-3
2018-01-20,3,Chandler,Yamauchi,Chandler,Unanimous,Crail,30,26,Denkin,30,25,Rosales,30,26,4,5,4
2018-01-20,3,Corrales,Karakhanyan,Corrales,Unanimous,Crail,30,27,Miner,29,28,Rosales,29,28,3,1,1
2018-01-20,3,Brock,Gracie,Brock,Unanimous,Crail,29,28,Denkin,29,28,Rosales,30,27,1,1,3
2018-01-20,3,Gozali,Campos,Campos,Unanimous,Crail,27,30,Denkin,27,30,Mccarthy,27,30,-3,-3,-3
2018-01-14,3,VanZant,Clark,Clark,Unanimous,Brown,27,30,Lee,28,29,Puccillo,28,29,-3,-1,-1
2018-01-14,3,Usman,Meek,Usman,Unanimous,Buesking,30,27,D'Amato,30,27,Rosales,30,27,3,3,3
2018-01-14,3,White,Krause,Krause,Unanimous,Buesking,28,29,D'Amato,28,29,Lee,28,29,-1,-1,-1
2018-01-14,3,Bernardo,Aldana,Aldana,Unanimous,Brown,27,30,Lee,27,30,Rosales,27,30,-3,-3,-3
2018-01-14,3,Faria,Eye,Eye,Split,D'Amato,28,29,Francis,29,28,Puccillo,28,29,-1,1,-1
2018-01-14,3,Taylor,Aldrich,Aldrich,Unanimous,Buesking,28,29,D'Amato,28,29,Francis,28,29,-1,-1,-1
2018-01-14,3,Santiago,Burnell,Burnell,Unanimous,Brown,28,29,Puccillo,28,29,Rosales,28,29,-1,-1,-1
2018-01-13,3,Kianzad,Kaufman,Kaufman,Unanimous,Danforth,27,30,Gueary,27,30,Swanberg,27,30,-3,-3,-3
2018-01-13,3,Jacobson,Nichols,Jacobson,Unanimous,Danforth,29,28,Gueary,29,28,Swanberg,30,27,1,1,3
2018-01-13,3,Cummins,Alba,Cummins,Unanimous,Danforth,30,27,Gueary,30,27,Swanberg,30,27,3,3,3
2018-01-13,3,Muraski,Walker,Walker,Split,Danforth,28,29,Gueary,28,29,Swanberg,29,28,-1,-1,1
2018-01-13,3,Spencer,Al-Hameed,Spencer,Unanimous,Danforth,30,27,Gueary,30,27,Swanberg,30,27,3,3,3
2018-01-13,3,Wang,Lookboonmee,Lookboonmee,Unanimous,Danforth,26,29,Gueary,27,29,Swanberg,27,29,-3,-2,-2
2017-12-30,5,Holm,Cyborg,Cyborg,Unanimous,Cleary,46,49,Hagen,47,48,Lee,47,48,-3,-1,-1
2017-12-30,3,Barboza,Nurmagomedov,Nurmagomedov,Unanimous,D'Amato,25,30,Kamijo,25,30,Trowbridge,24,30,-5,-5,-6
2017-12-30,3,Calvillo,Esparza,Esparza,Unanimous,D'Amato,28,29,Kamijo,28,29,Rosales,28,29,-1,-1,-1
2017-12-30,3,Condit,Magny,Magny,Unanimous,Cleary,27,30,Hagen,27,30,Trowbridge,28,29,-3,-3,-1
2017-12-30,3,Oleksiejczuk,Rountree Jr.,Oleksiejczuk,Unanimous,Kamijo,30,27,Rosales,30,27,Weeks,30,27,3,3,3
2017-12-30,3,Jury,Glenn,Jury,Unanimous,Hagen,30,27,Lee,30,27,Winter,30,27,3,3,3
2017-12-30,3,Smolka,Nicolau,Nicolau,Unanimous,Lee,26,30,Rosales,25,30,Winter,26,30,-4,-5,-4
2017-12-30,3,Vettori,Akhmedov,draw,Majority,D'Amato,28,28,Trowbridge,29,28,Weeks,28,28,0,1,0
2017-12-23,3,Szymanski,Wrzosek,Wrzosek,Unanimous,Lethaby,27,30,Pawlega,27,30,Porebski,27,30,-3,-3,-3
2017-12-23,3,Rajewski,Parnasse,Parnasse,Majority,Cartlidge,28,29,Lasota,29,29,Lethaby,28,29,-1,0,-1
2017-12-16,5,Lawler,dos Anjos,dos Anjos,Unanimous,Cleary,45,50,D'Amato,45,50,Rodgers,45,50,-5,-5,-5
2017-12-16,3,Ponzinibbio,Perry,Ponzinibbio,Unanimous,Lee,29,28,Rodgers,29,28,Therien,29,28,1,1,1
2017-12-16,3,Blachowicz,Cannonier,Blachowicz,Unanimous,Cleary,29,28,Rodgers,29,28,Therien,29,28,1,1,1
2017-12-16,3,Makdessi,Trujillo,Makdessi,Unanimous,D'Amato,30,27,Jackson,30,27,Lee,30,27,3,3,3
2017-12-16,3,Mein,Silva,Mein,Unanimous,Jackson,30,26,Lee,30,27,Rodgers,30,27,4,3,3
2017-12-15,3,Ligier,McDonald,McDonald,Unanimous,Hagen,27,30,Miner,27,30,Tirelli,27,30,-3,-3,-3
2017-12-15,3,Létourneau,Jackson,Létourneau,Unanimous,Hagen,30,27,Miner,30,27,Tirelli,30,27,3,3,3
2017-12-09,3,Leal,Nica,Leal,Unanimous,Colón,30,26,D'Amato,30,27,Miner,30,27,4,3,3
2017-12-09,3,Benitez,Knight,Benitez,Unanimous,Cleary,30,26,Rosales,30,26,Vierra,29,27,4,4,2
2017-12-09,3,Holtzman,Horcher,Holtzman,Unanimous,Cleary,30,27,Mccarthy,30,27,Mccoy,30,27,3,3,3
2017-12-09,3,Anders,Perez,Anders,Unanimous,Belardo,30,25,Mccarthy,30,26,Rosales,29,28,5,4,1
2017-12-09,3,Morales,Lopez,Lopez,Unanimous,Cleary,28,29,Rosales,27,30,Vierra,28,29,-1,-3,-1
2017-12-09,3,Carmouche,Davis,Davis,Split,Cleary,28,29,Mccarthy,28,29,Mccoy,29,28,-1,-1,1
2017-12-09,3,Saenz,Dvalishvili,Saenz,Split,Cleary,28,29,Mccarthy,29,28,Rosales,29,28,-1,1,1
2017-12-09,3,Perez,Alcântara,Perez,Unanimous,Belardo,30,27,Mccoy,29,28,Vierra,29,28,3,1,1
2017-12-08,5,Niedzwiedz,Maia,Maia,Unanimous,Gueary,46,49,Marquez,46,49,Swanberg,46,49,-3,-3,-3
2017-12-08,3,Morandin,Novaes,Morandin,Unanimous,Gueary,30,27,Marquez,30,27,Swanberg,30,27,3,3,3
2017-12-08,3,Rodriguez,Ferea,Rodriguez,Unanimous,Gueary,29,28,Marquez,30,27,Swanberg,29,28,1,3,1
2017-12-02,3,Pettis,Cejudo,Cejudo,Unanimous,Colón,27,30,D'Amato,27,30,Silbert,27,30,-3,-3,-3
2017-12-02,3,Waterson-Gomez,Torres,Torres,Unanimous,Colón,28,29,Miner,27,30,Silbert,28,29,-1,-3,-1
2017-12-02,3,Teymur,Klose,Teymur,Unanimous,Cleary,30,27,Colón,29,28,Lee,30,27,3,1,3
2017-12-02,3,Casey,Herrig,Herrig,Split,D'Amato,28,29,Miner,28,29,Silbert,29,28,-1,-1,1
2017-12-01,5,Montaño,Modafferi,Montaño,Unanimous,Cleary,50,45,Kamijo,49,46,Mullen,49,46,5,3,3
2017-12-01,3,O'Malley,Ware,O'Malley,Unanimous,D'Amato,29,28,Hagen,29,28,Lee,29,28,1,1,1
2017-12-01,3,Honchak,Murphy,Murphy,Split,Cleary,28,29,Kamijo,28,29,Mullen,29,28,-1,-1,1
2017-12-01,3,Bennett,Geltmacher,Geltmacher,Unanimous,Anderson,25,30,Bell,25,30,Mathisen,27,30,-5,-5,-3
2017-12-01,5,Blencowe,Budd,Budd,Split,Anderson,46,49,Bell,48,47,Sutherland,46,49,-3,1,-3
2017-12-01,3,Honeycutt,Lovato Jr.,Lovato Jr.,Unanimous,Anderson,27,30,Mathisen,27,30,Sutherland,28,29,-3,-3,-1
2017-12-01,3,Njokuani,Kato,Njokuani,Unanimous,Bell,30,27,Mathisen,30,27,Sutherland,30,27,3,3,3
2017-12-01,3,Piccolotti,Rickels,Rickels,Unanimous,Anderson,27,30,Bell,27,30,Sutherland,27,30,-3,-3,-3
2017-12-01,3,Sicilia,Galvão,Sicilia,Unanimous,Anderson,29,28,Bell,29,28,Mathisen,29,28,1,1,1
2017-12-01,3,Howard,Phillips,Phillips,Unanimous,Bell,27,30,Mathisen,27,30,Sutherland,26,30,-3,-3,-4
2017-12-01,3,Bennett,Fabian,draw,Majority,Mullen,28,28,Trowbridge,28,28,Weeks,29,27,0,0,2
2017-11-25,3,Amoussou,Steele,Steele,Unanimous,Cartlidge,27,29,Collett,27,29,Lethaby,28,29,-2,-2,-1
2017-11-25,3,Lee,Desmae,Desmae,Unanimous,Cartlidge,26,29,Collett,28,29,Lethaby,27,29,-3,-1,-2
2017-11-25,3,Guan,Caceres,Guan,Split,Papaioannou,28,29,Shen,29,28,Sutherland,29,28,-1,1,1
2017-11-25,3,Xiaonan,Curran,Xiaonan,Unanimous,Foley,29,28,Papaioannou,29,28,Shen,30,27,1,1,3
2017-11-25,3,Mazany,Yanan,Mazany,Unanimous,Field,30,27,Papaioannou,30,27,Shen,30,27,3,3,3
2017-11-25,3,Dy,Buren,Dy,Unanimous,Keech,29,28,Shen,30,27,Sutherland,30,27,1,3,3
2017-11-19,5,Werdum,Tybura,Werdum,Unanimous,Dimitriou,50,45,Keech,49,46,Papaioannou,50,45,5,3,5
2017-11-19,3,Rawlings,Clark,Clark,Split,Field,29,28,Keech,28,29,Oshyer,28,29,1,-1,-1
2017-11-19,3,Means,Muhammad,Muhammad,Split,Field,28,29,Keech,29,28,Manderson,28,29,-1,1,-1
2017-11-19,3,Matthews,Velickovic,Matthews,Split,Dimitriou,29,28,Oshyer,29,28,Papaioannou,28,29,1,1,-1
2017-11-19,3,Kelly,Theodorou,Theodorou,Unanimous,Aliendi,28,30,Field,27,30,Keech,26,30,-2,-3,-4
2017-11-19,3,Volkanovski,Young,Volkanovski,Unanimous,Dimitriou,30,27,Manderson,30,26,Papaioannou,30,26,3,4,4
2017-11-19,3,Brown,Camacho,Camacho,Split,Aliendi,28,29,Field,27,30,Manderson,29,28,-1,-3,1
2017-11-19,3,Kassem,Chambers,Kassem,Unanimous,Dimitriou,29,27,Oshyer,29,27,Papaioannou,29,28,2,2,1
2017-11-19,3,Lausa,Shelton,Shelton,Unanimous,Aliendi,26,30,Field,27,30,Keech,25,30,-4,-3,-5
2017-11-19,3,Hamilton,Wieczorek,Wieczorek,Unanimous,Dimitriou,28,29,Keech,28,29,Oshyer,28,29,-1,-1,-1
2017-11-16,3,Lahat,Labiano,Lahat,Unanimous,Bell,29,27,Colón,29,27,D'Amato,29,27,2,2,2
2017-11-16,3,Rocha,Shay,Rocha,Unanimous,Bell,30,27,Colón,30,27,Miner,29,28,3,3,1
2017-11-16,3,Silva,Gosh,Gosh,Unanimous,Bell,27,30,D'Amato,27,30,Miner,27,30,-3,-3,-3
2017-11-16,3,Bring,Kablan,Bring,Unanimous,Colón,30,27,D'Amato,30,27,Macdonald,30,27,3,3,3
2017-11-16,3,Sianov,Levi,Levi,Majority,Bell,28,28,Colón,28,29,D'Amato,28,29,0,-1,-1
2017-11-11,3,Albini,Arlovski,Arlovski,Unanimous,Cleary,28,29,Lee,27,30,Mullen,27,30,-1,-3,-3
2017-11-11,3,Ferreira,Marquardt,Ferreira,Split,Costello,29,28,Lee,28,29,Mullen,29,28,1,-1,1
2017-11-11,3,Dodson,Moraes,Moraes,Split,Costello,27,30,Lee,27,30,Rodriguez,30,27,-3,-3,3
2017-11-11,3,Pereira,Suarez,Suarez,Unanimous,Bello,27,30,Costello,27,30,Mullen,25,30,-3,-3,-5
2017-11-11,3,Northcutt,Quinones,Northcutt,Unanimous,Belhumeur,30,27,Cleary,30,27,Rodriguez,30,27,3,3,3
2017-11-11,3,Hill,Nunes,Nunes,Unanimous,Costello,28,29,Lee,28,29,Rodriguez,28,29,-1,-1,-1
2017-11-11,3,Strickland,McGee,Strickland,Unanimous,Belhumeur,30,27,Cleary,29,28,Mullen,29,28,3,1,1
2017-11-11,3,Fortuna,Collier,Collier,Unanimous,Costello,28,29,Lemm,27,30,Rodriguez,28,29,-1,-3,-1
2017-11-10,3,Redmond,de Jesus Santos,Redmond,Unanimous,Colón,29,27,D'Amato,29,27,Miner,29,27,2,2,2
2017-11-04,3,Thompson,Masvidal,Thompson,Unanimous,Colón,30,27,D'Amato,30,26,Tirelli,30,27,3,4,3
2017-11-04,3,Brown,Gall,Brown,Unanimous,Cleary,29,28,Lee,29,27,Tirelli,29,28,1,2,1
2017-11-03,3,Davis,Leite,Davis,Unanimous,Brogan,30,27,Colón,30,27,Urso,30,27,3,3,3
2017-11-03,3,Storley,Secor,Storley,Unanimous,Monskie,30,27,Sparacino,30,27,Urso,30,26,3,3,4
2017-11-03,3,Healy,Buenafuente,Buenafuente,Unanimous,Brogan,28,29,Kruszka,27,30,Sparacino,28,29,-1,-3,-1
2017-10-28,3,Maia,Covington,Covington,Unanimous,Bravo,27,29,Cleary,27,30,Tirelli,26,30,-2,-3,-4
2017-10-28,3,Miller,Trinaldo,Trinaldo,Unanimous,Iorio,28,29,Rosales,28,29,Tirelli,28,29,-1,-1,-1
2017-10-28,3,Lineker,Vera,Lineker,Unanimous,Bravo,29,28,Cleary,29,28,Rosales,30,27,1,1,3
2017-10-28,3,Gordon,Dias,Gordon,Unanimous,Bravo,29,26,Iorio,29,27,Pontes,30,26,3,2,4
2017-10-28,3,Zaleski dos Santos,Griffin,Zaleski dos Santos,Unanimous,Bravo,29,28,Cleary,29,28,Tirelli,29,27,1,1,2
2017-10-28,3,Figueiredo,Brooks,Figueiredo,Split,Bravo,27,30,Iorio,29,28,Tirelli,29,28,-3,1,1
2017-10-28,5,Cheng,Chadwick,Chadwick,Unanimous,Cartlidge,47,48,Collett,47,48,Lethaby,47,48,-1,-1,-1
2017-10-28,3,McCann,de Souza,McCann,Unanimous,Cartlidge,29,27,Collett,29,28,Lethaby,29,27,2,1,2
2017-10-28,3,Stanton,McManus,Stanton,Unanimous,Cartlidge,30,27,Collett,30,27,Lethaby,29,27,3,3,2
2017-10-22,3,Pudzianowski,Silva,Pudzianowski,Majority,Bonkowski,29,28,Lethaby,28,28,Porebski,29,28,1,0,1
2017-10-22,3,Zawada,Jewtuszko,Zawada,Unanimous,Bonkowski,30,26,Browne,30,27,Lethaby,30,26,4,3,4
2017-10-22,3,Fields,Fijalka,Fields,Unanimous,Bonkowski,30,27,Cartlidge,29,28,Domasat,30,27,3,1,3
2017-10-22,3,Chlewicki,Redmond,Redmond,Split,Bonkowski,27,30,Domasat,29,28,Lethaby,27,30,-3,1,-3
2017-10-22,3,Lawrence,Iwanowski,Lawrence,Split,Browne,28,29,Cartlidge,29,28,Porebski,30,27,-1,1,3
2017-10-22,3,Politylo,Racic,Racic,Split,Browne,28,29,Domasat,28,29,Porebski,29,28,-1,-1,1
2017-10-21,3,Esquibel,Kowalkiewicz,Kowalkiewicz,Unanimous,Cartlidge,27,30,Grüner,27,30,Harasim,27,30,-3,-3,-3
2017-10-21,3,Piechota,Wilson,Piechota,Unanimous,Cartlidge,30,27,Grüner,30,27,Motylewski,30,27,3,3,3
2017-10-21,3,Haqparast,Held,Held,Unanimous,Collett,27,30,Harasim,27,30,Sutherland,27,30,-3,-3,-3
2017-10-21,3,Alvey,Emeev,Emeev,Unanimous,Collett,27,30,Harasim,27,30,Sutherland,27,30,-3,-3,-3
2017-10-21,3,Lobov,Fili,Fili,Unanimous,Cartlidge,27,30,Sutherland,27,30,Wojciechowski,27,30,-3,-3,-3
2017-10-21,3,Alves,Touahri,Alves,Unanimous,Collett,29,28,Grüner,29,28,Motylewski,30,27,1,1,3
2017-10-21,3,Arantes,Emmett,Emmett,Unanimous,Cartlidge,26,30,Motylewski,26,30,Sutherland,25,30,-4,-4,-5
2017-10-20,3,Mousasi,Shlemenko,Mousasi,Unanimous,Cleary,29,28,Crosby,29,28,English,29,28,1,1,1
2017-10-20,3,Surin,Quinn,Quinn,Unanimous,Cleary,28,29,Mullen,28,29,Peabody,28,29,-1,-1,-1
2017-10-20,3,Blaine,Julaton,Blaine,Split,Cleary,29,28,Crosby,29,28,Mullen,28,29,1,1,-1
2017-10-20,3,Lopez,Giovanella,Lopez,Unanimous,Crosby,30,26,English,30,27,Mullen,29,28,4,3,1
2017-10-20,3,Perez,Carrier,Carrier,Unanimous,Cleary,27,30,Mullen,27,30,Peabody,27,30,-3,-3,-3
2017-10-20,3,Buckley,de Jesus,Buckley,Split,Cleary,29,28,Crosby,29,28,Mullen,28,29,1,1,-1
2017-10-14,3,Houston,Khalid,Houston,Unanimous,Cartlidge,30,27,Collett,30,27,Lethaby,30,27,3,3,3
2017-10-14,3,Holm,Filipa,Holm,Unanimous,Cartlidge,30,27,Collett,30,27,Lethaby,30,27,3,3,3
2017-10-14,3,Tracey,Ellis,Tracey,Unanimous,Cartlidge,29,28,Collett,29,28,Lethaby,29,28,1,1,1
2017-10-07,3,Stamann,Duquesnoy,Stamann,Split,Lee,28,29,Rosales,30,27,Winter,29,28,-1,3,1
2017-10-07,3,Botelho,Gonzalez,Botelho,Unanimous,D'Amato,30,27,Lee,30,27,Winter,30,27,3,3,3
2017-10-07,3,Beltran,Schnell,Schnell,Unanimous,D'Amato,27,30,Mullen,28,29,Rosales,27,30,-3,-1,-3
2017-10-07,3,Leites,Tavares,Tavares,Unanimous,D'Amato,26,30,Hagen,26,30,Trowbridge,27,30,-4,-4,-3
2017-10-07,3,Dunham,Dariush,draw,Majority,D'Amato,28,29,Hagen,28,28,Trowbridge,28,28,-1,0,0
2017-10-07,3,Green,Vannata,draw,Split,Cleary,28,28,Mullen,27,29,Rosales,29,27,0,-2,2
2017-10-06,5,Caldwell,Dantas,Caldwell,Unanimous,Anderson,50,45,Bell,48,47,Sutherland,48,47,5,1,1
2017-10-06,3,Curran,Macapa,Curran,Unanimous,Bell,29,28,Sutherland,30,26,Turnage,30,27,1,4,3
2017-10-06,3,Higo,Taimanglo,Higo,Unanimous,Anderson,29,28,Bell,30,27,Turnage,30,27,1,3,3
2017-10-06,3,Rivera,Muro,Muro,Unanimous,Bell,27,30,Sutherland,27,30,Turnage,27,30,-3,-3,-3
2017-10-06,3,Banks,Kozola,Banks,Unanimous,Anderson,30,25,Bell,30,27,Turnage,30,25,5,3,5
2017-09-23,3,Henderson,Freire,Freire,Split,Cleary,29,28,Rosales,28,29,Vierra,28,29,1,-1,-1
2017-09-23,3,Ayala,Nelson,Nelson,Unanimous,Guingona,28,29,Rosales,28,29,Vierra,26,30,-1,-1,-4
2017-09-23,3,Mayo,Neil,Neil,Unanimous,Coffey,28,29,Rosales,28,29,Vierra,28,29,-1,-1,-1
2017-09-23,3,Nievara,Herrera,Nievara,Unanimous,Cleary,29,28,Coffey,29,27,Thomas-Gitlin,30,26,1,2,4
2017-09-23,3,Lopez,Gonzalez Trevino,Gonzalez Trevino,Split,Cleary,28,29,Guingona,28,29,Rosales,29,28,-1,-1,1
2017-09-23,3,Andrade,Gadelha,Andrade,Unanimous,Dimitriou,30,26,Foley,30,25,Papaioannou,30,27,4,5,3
2017-09-23,3,Ishihara,Dy,Ishihara,Unanimous,Cartlidge,28,27,Field,29,26,Keech,28,27,1,3,1
2017-09-23,3,Nakamura,Morono,Nakamura,Split,Cartlidge,29,28,Foley,28,29,Keech,29,28,1,-1,1
2017-09-23,3,Kondo,Jeon,Kondo,Split,Cartlidge,30,27,Dimitriou,30,27,Field,28,29,3,3,-1
2017-09-23,3,Jumeau,Anzai,Anzai,Unanimous,Foley,28,29,Kamijo,28,29,Papaioannou,27,30,-1,-1,-3
2017-09-23,3,Abe,Lim,Abe,Unanimous,Dimitriou,29,28,Field,29,28,Keech,29,28,1,1,1
2017-09-16,3,Ledet,Anyanwu,Ledet,Split,Brogan,29,28,Colón,28,29,Urso,29,28,1,-1,1
2017-09-16,3,Aubin-Mercier,Martin,Aubin-Mercier,Split,Colón,28,29,Monskie,29,28,Mullen,29,28,-1,1,1
2017-09-16,3,Carter,McColgan,McColgan,Split,Cartlidge,27,30,Collett,29,28,Lethaby,28,29,-3,1,-1
2017-09-09,5,Nunes,Shevchenko,Nunes,Split,D'Amato,48,47,Therien,48,47,Weeks,47,48,1,1,-1
2017-09-09,3,Latifi,Pedro,Latifi,Unanimous,D'Amato,30,27,Dorchester,29,28,Weeks,29,28,3,1,1
2017-09-09,3,Melendez,Stephens,Stephens,Unanimous,Collins,26,30,Hagen,25,30,Therien,26,30,-4,-5,-4
2017-09-09,3,Glenn,Tucker,Glenn,Unanimous,D'Amato,30,24,Gerke,29,27,Hagen,30,25,6,2,5
2017-09-09,3,Bhullar,Henrique,Bhullar,Unanimous,Donahue,29,28,Hagen,29,28,Therien,29,28,1,1,1
2017-09-02,3,Edwards,Barberena,Edwards,Unanimous,Cartlidge,29,28,Hughes,29,28,Sutherland,29,28,1,1,1
2017-09-02,3,Velickovic,Till,Till,Unanimous,Cartlidge,27,30,Kobayashi,27,30,Sutherland,27,30,-3,-3,-3
2017-09-02,3,Khabilov,Green,Khabilov,Unanimous,Kobayashi,29,28,Roberts,30,27,Sutherland,29,28,1,3,1
2017-09-02,3,Barroso,Rakic,Rakic,Unanimous,Cartlidge,27,30,Kobayashi,27,30,Sutherland,27,30,-3,-3,-3
2017-08-31,5,Kunitskaya,Canuto,Kunitskaya,Unanimous,Belardo,50,45,Lawley,50,45,Mccoy,50,45,5,5,5
2017-08-31,3,Morandin,Souza,Souza,Unanimous,Belardo,27,30,Lawley,28,29,Rosenthal,28,29,-3,-1,-1
2017-08-31,3,Anderson,VanHoose,VanHoose,Split,Belardo,29,28,Lawley,27,30,Rosenthal,28,29,1,-3,-1
2017-08-31,3,Orr,Kleczka,Kleczka,Split,Belardo,29,28,Mccoy,28,29,Rosenthal,28,29,1,-1,-1
2017-08-31,3,DeCoursey,Medina,DeCoursey,Split,Belardo,29,28,Mccoy,28,29,Rosenthal,29,28,1,-1,1
2017-08-25,3,Arteaga,Ellen,Ellen,Split,Colón,29,28,D'Amato,28,29,Lee,28,29,1,-1,-1
2017-08-25,3,McKee,Tugman,McKee,Unanimous,Colón,30,27,Lee,30,26,Tirelli,30,26,3,4,4
2017-08-25,3,Rainey,Stevens,Rainey,Unanimous,D'Amato,29,27,Lee,29,27,Tirelli,29,27,2,2,2
2017-08-25,3,Lahat,Corrales,Corrales,Unanimous,Colón,28,29,Lee,27,30,Tirelli,28,29,-1,-3,-1
2017-08-25,3,Blencowe,Kavanagh,Blencowe,Split,Bruce,28,29,Lee,29,28,Tirelli,30,27,-1,1,3
2017-08-05,5,Pettis,Moreno,Pettis,Unanimous,Cleary,49,46,Colón,48,46,Mullen,48,46,3,2,2
2017-08-05,3,Markos,Grasso,Grasso,Split,Rosales,28,29,Silbert,28,29,Tirelli,29,28,-1,-1,1
2017-08-05,3,Alvey,Evans,Alvey,Split,Cleary,29,28,Colón,29,28,Mullen,28,29,1,1,-1
2017-08-05,3,Soukhamthath,Perez,Perez,Split,Jimenez,29,28,Mullen,28,29,Silbert,28,29,1,-1,-1
2017-08-05,3,Quinonez,Rivas,Quinonez,Unanimous,Jimenez,30,27,Mullen,30,27,Rosales,30,27,3,3,3
2017-07-29,5,Maia,Woodley,Woodley,Unanimous,D'Amato,46,49,Rosales,45,50,Vierra,46,49,-3,-5,-3
2017-07-29,3,Cerrone,Lawler,Lawler,Unanimous,Bell,28,29,Cleary,28,29,Rosales,28,29,-1,-1,-1
2017-07-29,3,Sterling,Barão,Sterling,Unanimous,Cleary,29,27,Rosales,30,26,Vierra,29,28,2,4,1
2017-07-29,3,Fili,Kattar,Kattar,Unanimous,Bell,27,30,Bravo,27,30,Saucedo,27,30,-3,-3,-3
2017-07-29,3,Albu,Curran,Albu,Unanimous,D'Amato,29,28,Rosales,29,28,Vierra,29,28,1,1,1
2017-07-29,3,Shelton,Brooks,Brooks,Split,Bravo,29,28,Saucedo,28,29,Vierra,28,29,1,-1,-1
2017-07-22,3,Bermudez,Elkins,Elkins,Split,Crosby,28,29,Miner,29,28,Tirelli,28,29,-1,1,-1
2017-07-22,3,Villante,Cummins,Cummins,Split,D'Amato,29,28,Mullen,28,29,Tirelli,28,29,1,-1,-1
2017-07-22,3,Rivera,Almeida,Rivera,Unanimous,Crosby,30,26,Miner,30,27,Urso,29,28,4,3,1
2017-07-22,3,Zaleski dos Santos,Good,Zaleski dos Santos,Split,Crosby,30,27,Mullen,30,27,Urso,28,29,3,3,-1
2017-07-22,3,Grabowski,Sherman,Sherman,Unanimous,D'Amato,27,30,Tirelli,27,30,Urso,26,30,-3,-3,-4
2017-07-22,3,Kennedy,Bochniak,Kennedy,Unanimous,D'Amato,30,27,Miner,30,27,Mullen,29,28,3,3,1
2017-07-22,3,Pepey,Burgos,Burgos,Unanimous,Crosby,26,30,D'Amato,26,30,Urso,28,29,-4,-4,-1
2017-07-22,3,Wade,Perez,Wade,Unanimous,D'Amato,29,28,Mullen,29,28,Tirelli,30,27,1,1,3
2017-07-16,3,Wood,Calvillo,Calvillo,Unanimous,Harasim,27,30,Hughes,28,29,Motylewski,27,30,-3,-1,-3
2017-07-16,3,Marshman,Janes,Marshman,Unanimous,Collett,29,28,Harasim,29,28,Hughes,29,28,1,1,1
2017-07-16,3,Willis,Mulheron,Willis,Unanimous,Harasim,30,27,Motylewski,30,27,Sutherland,30,27,3,3,3
2017-07-16,3,Teymur,Henry,Henry,Unanimous,Collett,26,29,Harasim,28,29,Hughes,28,29,-3,-1,-1
2017-07-16,3,Johns,Morales,Johns,Unanimous,Cartlidge,30,27,Motylewski,30,27,Sutherland,30,25,3,3,5
2017-07-15,3,Dudieva,Romero Borella,Romero Borella,Split,Danforth,27,30,Gueary,29,28,Swanberg,28,29,-3,1,-1
2017-07-15,3,Cummins,Frey,Frey,Unanimous,Gueary,27,30,Miller,28,29,Swanberg,27,30,-3,-1,-3
2017-07-15,3,Romero,Maverick,Maverick,Unanimous,Danforth,26,30,Gueary,28,29,Swanberg,27,30,-4,-1,-3
2017-07-15,3,D'Angelo,Davidsdottir,Davidsdottir,Unanimous,Gueary,26,30,Miller,27,30,Swanberg,27,30,-4,-3,-3
2017-07-14,3,Florentino,Gary,Gary,Unanimous,Cleary,28,29,Hinds,28,29,Maness,28,29,-1,-1,-1
2017-07-14,3,Ducote,Middleton,Ducote,Unanimous,Cleary,29,28,Hinds,29,27,Maness,29,28,1,2,1
2017-07-14,3,Warren,Garcia,Warren,Unanimous,Cleary,30,27,Maness,30,27,Mathisen,30,27,3,3,3
2017-07-14,3,Brooks,Bomba,Brooks,Unanimous,Cleary,30,27,Hinds,29,28,Mathisen,29,28,3,1,1
2017-07-14,3,Moldavsky,Seumanutafa,Moldavsky,Unanimous,Cleary,30,26,Maness,30,27,Mathisen,30,26,4,3,4
2017-07-14,3,Fialho,Matthews,Fialho,Split,Cleary,29,28,Hinds,29,28,Maness,28,29,1,1,-1
2017-07-14,3,Cotton,Rodriguez,Cotton,Split,Cleary,30,27,Hinds,27,30,Mathisen,29,28,3,-3,1
2017-07-14,3,Collins,Vargas,Collins,Unanimous,Cleary,30,27,Maness,30,27,Mathisen,30,27,3,3,3
2017-07-08,5,Whittaker,Romero,Whittaker,Unanimous,D'Amato,48,47,Kamijo,48,47,Mullen,48,47,1,1,1
2017-07-08,3,Overeem,Werdum,Overeem,Majority,Cleary,28,28,Hagen,29,28,Lee,29,28,0,1,1
2017-07-08,3,Omielanczuk,Blaydes,Blaydes,Unanimous,Kamijo,27,30,Mullen,27,30,Trowbridge,27,30,-3,-3,-3
2017-07-08,3,Miller,Pettis,Pettis,Unanimous,Cleary,27,30,D'Amato,27,30,Rosales,27,30,-3,-3,-3
2017-07-08,3,Mein,Muhammad,Muhammad,Unanimous,Cleary,27,30,D'Amato,28,29,Mullen,28,29,-3,-1,-1
2017-07-08,3,Stamann,Ware,Stamann,Unanimous,Kamijo,30,27,Rosales,30,27,Trowbridge,29,28,3,3,1
2017-07-07,3,Klose,Diakiese,Klose,Split,Cleary,28,29,Mullen,29,28,Rosales,29,28,-1,1,1
2017-07-07,3,Theodorou,Tavares,Tavares,Unanimous,Cleary,28,29,Mullen,28,29,Weeks,28,29,-1,-1,-1
2017-07-07,3,Johnson,Fortuna,Johnson,Unanimous,Lee,29,28,Morse Jarman,29,28,Rosales,29,28,1,1,1
2017-07-07,3,Hill,Yoder,Hill,Unanimous,D'Amato,30,27,Kamijo,30,27,Weeks,30,27,3,3,3
2017-07-07,3,Gallicchio,Krause,Krause,Unanimous,Hagen,27,30,Morse Jarman,27,30,Rosales,27,30,-3,-3,-3
2017-07-07,3,Herman,Dollaway,Dollaway,Unanimous,Lee,28,29,Mullen,27,29,Weeks,27,29,-1,-2,-2
2017-07-07,3,Ishihara,Maynard,Maynard,Unanimous,Cleary,26,30,Kamijo,26,30,Weeks,26,30,-4,-4,-4
2017-07-02,12,Pacquiao,Horn,Horn,Unanimous,Cerdan,113,115,Flores,113,115,Roldan,111,117,-2,-2,-6
2017-06-25,3,Herrig,Kish,Herrig,Unanimous,Puccillo,30,26,Ritter,30,26,Trowbridge,29,27,4,4,2
2017-06-25,3,Means,Garcia,Means,Unanimous,Puccillo,29,28,Sutherland,29,28,Trowbridge,29,28,1,1,1
2017-06-25,3,Siver,Penn,Siver,Majority,Ritter,29,27,Rosales,28,28,Urso,29,28,2,0,1
2017-06-25,3,Koch,Guida,Guida,Unanimous,Puccillo,26,30,Sutherland,28,29,Trowbridge,26,29,-4,-1,-3
2017-06-25,3,Vettori,Miranda,Vettori,Unanimous,Ritter,30,27,Rosales,29,28,Urso,30,27,3,1,3
2017-06-25,3,Moroz,Esparza,Esparza,Unanimous,Puccillo,27,30,Sutherland,28,29,Trowbridge,28,29,-3,-1,-1
2017-06-25,3,Powell,Horcher,Horcher,Split,Ritter,28,29,Rosales,29,28,Urso,28,29,-1,1,-1
2017-06-25,3,Martin,Case,Martin,Unanimous,Puccillo,29,28,Sutherland,29,28,Trowbridge,29,28,1,1,1
2017-06-24,3,Desmae,Stapleton,Stapleton,Unanimous,Cartlidge,25,30,Collett,26,30,Lethaby,27,30,-5,-4,-3
2017-06-24,3,Luther,Finocchio,Finocchio,Unanimous,Cartlidge,27,28,Collett,26,29,Lethaby,26,29,-1,-3,-3
2017-06-24,3,Silva,Sonnen,Sonnen,Unanimous,D'Amato,26,30,Mullen,27,30,Tirelli,27,30,-4,-3,-3
2017-06-24,5,Lima,Larkin,Lima,Unanimous,Crosby,48,47,Lee,50,45,Tirelli,48,47,1,5,1
2017-06-24,5,Bader,Davis,Bader,Split,Cleary,49,46,D'Amato,49,46,Mullen,47,48,3,3,-1
2017-06-17,3,Tybura,Arlovski,Tybura,Unanimous,Booth,29,28,Field,28,27,Shen,29,27,1,1,2
2017-06-17,3,Covington,Kim,Covington,Unanimous,Booth,30,27,Field,30,25,Shen,30,26,3,5,4
2017-06-17,3,Saffiedine,dos Anjos,dos Anjos,Unanimous,Foley,27,30,Papaioannou,27,30,Shen,28,29,-3,-3,-1
2017-06-17,3,Camacho,Jingliang,Jingliang,Unanimous,Booth,27,28,Field,27,29,Shen,27,29,-1,-2,-2
2017-06-17,3,Inoue,de Tomas,Inoue,Unanimous,Foley,30,26,Papaioannou,30,26,Shen,30,26,4,4,4
2017-06-17,3,Pudilova,Kim,Pudilova,Unanimous,Booth,29,28,Dimitriou,29,28,Field,29,28,1,1,1
2017-06-11,3,Volkanovski,Hirota,Volkanovski,Unanimous,Gerard,30,27,Hickmott,30,27,Rodgers,30,27,3,3,3
2017-06-11,3,Steele,Jumeau,Jumeau,Unanimous,Booth,28,29,Hickmott,28,29,Quinn,28,29,-1,-1,-1
2017-06-11,3,Mokhtarian,Moraga,Moraga,Unanimous,Foley,25,30,Hill,27,30,Rodgers,27,30,-5,-3,-3
2017-06-11,3,Ottow,Kunimoto,Ottow,Split,Hickmott,29,28,Hill,28,29,Keech,29,28,1,-1,1
2017-06-11,3,Jeon,Aldrich,Aldrich,Unanimous,Gerard,27,30,Keech,27,30,Quinn,27,30,-3,-3,-3
2017-06-03,3,Belfort,Marquardt,Belfort,Unanimous,Iorio,29,28,Lee,29,28,Mullen,29,28,1,1,1
2017-06-03,3,Assuncao,Moraes,Assuncao,Split,Alves,28,29,Bravo,29,28,Iorio,30,27,-1,1,3
2017-06-03,3,Pereira,Moyle,Pereira,Unanimous,Alves,29,28,Cleary,30,27,Mullen,30,27,1,3,3
2017-06-02,3,Wheeler,Inman,Inman,Unanimous,Cartlidge,25,30,Collett,26,30,Lethaby,25,30,-5,-4,-5
2017-06-02,3,Green,Jacobsen,Jacobsen,Unanimous,Cartlidge,26,30,Collett,26,30,Lethaby,27,30,-4,-4,-3
2017-06-02,3,Robertsen,Wells,Robertsen,Unanimous,Cartlidge,29,28,Collett,29,28,Lethaby,29,28,1,1,1
2017-06-02,3,Webb,Jurkovic,Jurkovic,Unanimous,Cartlidge,27,30,Collett,27,30,Lethaby,27,30,-3,-3,-3
2017-05-28,3,Alhassan,Akhmedov,Akhmedov,Split,Nilsson,27,30,Roberts,27,30,Segerlind,29,28,-3,-3,1
2017-05-28,3,Enkamp,Taleb,Taleb,Unanimous,Ohlsson,28,29,Roberts,27,30,Segerlind,27,30,-1,-3,-3
2017-05-28,3,Stasiak,Munhoz,Munhoz,Unanimous,Nilsson,27,29,Ohlsson,27,30,Roberts,28,29,-2,-3,-1
2017-05-28,3,Smith,Camozzi,Smith,Unanimous,Cartlidge,30,26,Grüner,30,26,Segerlind,30,27,4,4,3
2017-05-28,3,Madadi,Silva,Silva,Split,Grüner,29,28,Nilsson,28,29,Roberts,28,29,1,-1,-1
2017-05-28,3,Till,Ayari,Till,Unanimous,Cartlidge,30,27,Nilsson,29,27,Ohlsson,30,27,3,2,3
2017-05-27,3,Khalidov,Mankowski,Khalidov,Unanimous,Lethaby,29,28,Motylewski,29,28,Wojciechowski,30,27,1,1,3
2017-05-27,3,Sokoudjou,Jurkowski,Jurkowski,Split,Cartlidge,29,28,Lethaby,28,29,Porebski,28,29,1,-1,-1
2017-05-27,3,Gamrot,Parke,Gamrot,Unanimous,Cartlidge,29,28,Motylewski,29,28,Wojciechowski,29,28,1,1,1
2017-05-27,3,Koike,Wrzosek,Koike,Unanimous,Cartlidge,29,27,Pawlega,29,27,Wojciechowski,29,28,2,2,1
2017-05-20,3,Porto,Niedzwiedz,Niedzwiedz,Unanimous,Champion,28,29,Gueary,28,29,Swanberg,28,29,-1,-1,-1
2017-05-20,3,Simpson,Tiburcio,Tiburcio,Split,Champion,28,29,Gueary,28,29,Swanberg,29,28,-1,-1,1
2017-05-20,3,Faszholz,Phillips,Faszholz,Unanimous,Champion,30,27,Gueary,30,27,Swanberg,30,27,3,3,3
2017-05-20,3,Tracy,Lee,Lee,Split,Champion,28,29,Gueary,27,30,Swanberg,29,28,-1,-3,1
2017-05-20,3,Gomes,Sorenson,Gomes,Split,Champion,29,28,Gueary,28,29,Swanberg,29,28,1,-1,1
2017-05-20,3,Ferea,van Soest,van Soest,Unanimous,Champion,28,29,Gueary,28,29,Swanberg,28,29,-1,-1,-1
2017-05-20,3,Bayard,Rincon,Rincon,Unanimous,Champion,28,29,Gueary,27,30,Swanberg,28,29,-1,-3,-1
2017-05-19,3,Sakai,Kongo,Kongo,Split,Crosby,28,29,D'Amato,29,28,Tirelli,28,29,-1,1,-1
2017-05-19,3,Albazi,Powell,Albazi,Unanimous,Colón,30,26,D'Amato,30,25,Tirelli,30,26,4,5,4
2017-05-19,3,Petley,Morton,Petley,Unanimous,Colón,30,27,D'Amato,29,28,Tirelli,30,26,3,1,4
2017-05-13,5,Andrade,Jedrzejczyk,Jedrzejczyk,Unanimous,D'Amato,44,50,Mullen,45,50,Wincapaw,45,50,-6,-5,-5
2017-05-13,3,Masvidal,Maia,Maia,Split,D'Amato,28,29,Martinez,29,28,Mullen,28,29,-1,1,-1
2017-05-13,3,Jotko,Branch,Branch,Split,Mullen,28,29,Reed,29,28,Wincapaw,28,29,-1,1,-1
2017-05-13,3,Aguilar,Casey,Casey,Unanimous,Martinez,27,30,Mathisen,27,30,Wincapaw,27,30,-3,-3,-3
2017-05-13,3,Barzola,Benitez,Barzola,Unanimous,Martinez,29,28,Mathisen,29,28,Reed,29,28,1,1,1
2017-05-06,3,Clist,Bak,Bak,Unanimous,Cartlidge,25,30,Collett,24,30,Lethaby,25,30,-5,-6,-5
2017-05-06,3,Ott,Maksimovic,Ott,Unanimous,Cartlidge,29,27,Collett,29,27,Lethaby,29,28,2,2,1
2017-04-22,5,Swanson,Lobov,Swanson,Unanimous,Cleary,49,46,Lee,49,46,Mullen,50,45,3,3,5
2017-04-22,3,Dodson,Wineland,Dodson,Unanimous,Colón,29,28,Maness,30,27,Silbert,30,27,1,3,3
2017-04-22,3,Ray,Lauzon,Ray,Majority,Lee,28,27,Mullen,29,27,Tirelli,28,28,1,2,0
2017-04-22,3,Alvey,Leites,Leites,Unanimous,Lee,27,30,Maness,27,30,Tirelli,27,30,-3,-3,-3
2017-04-22,3,Holtzman,McBride,Holtzman,Unanimous,Cleary,30,27,Lee,30,26,Tirelli,30,27,3,4,3
2017-04-22,3,Taylor,Penne,Taylor,Unanimous,Colón,29,28,Mullen,29,28,Silbert,29,28,1,1,1
2017-04-22,3,Davis,Dandois,Davis,Unanimous,Lee,29,28,Mullen,29,28,Silbert,29,28,1,1,1
2017-04-21,3,Awad,Quinn,Awad,Unanimous,Colón,30,27,D'Amato,30,27,Sanidad,30,27,3,3,3
2017-04-15,3,Moicano,Stephens,Moicano,Split,Puccillo,29,28,Rosales,28,29,Weeks,29,28,1,-1,1
2017-04-15,3,Nelson,Volkov,Volkov,Unanimous,D'Amato,27,30,Francis,27,30,Gueary,27,30,-3,-3,-3
2017-04-15,3,Magomedov,Green,Magomedov,Split,Francis,28,29,Puccillo,29,28,Urso,29,28,-1,1,1
2017-04-15,3,Smolka,Elliott,Elliott,Unanimous,Gueary,27,30,Rosales,27,30,Weeks,27,30,-3,-3,-3
2017-04-15,3,Sterling,Mendes,Sterling,Unanimous,D'Amato,29,28,Rosales,29,28,Urso,29,28,1,1,1
2017-04-15,3,Collier,Clark,Clark,Unanimous,D'Amato,26,30,Francis,27,30,Urso,27,30,-4,-3,-3
2017-04-15,3,Evans-Smith,Vieira,Vieira,Unanimous,D'Amato,28,29,Gueary,27,30,Rosales,28,29,-1,-3,-1
2017-04-14,3,Dantas,Higo,Dantas,Split,Miner,30,27,Mullen,28,29,Tirelli,30,27,3,-1,3
2017-04-14,3,Weichel,Macapa,Weichel,Split,Miner,28,29,Mullen,29,28,Tirelli,29,28,-1,1,1
2017-04-08,3,Kallionidou,Yankova,Yankova,Unanimous,Bell,27,30,Lee,27,30,Miner,28,29,-3,-3,-1
2017-04-08,3,Mircea,Chan,Mircea,Majority,Bell,28,28,Lee,29,28,Miner,29,28,0,1,1
2017-04-08,3,Cote,Alves,Alves,Unanimous,Cleary,27,30,D'Amato,27,30,Mullen,27,30,-3,-3,-3
2017-04-08,3,Strickland,Usman,Usman,Unanimous,D'Amato,27,30,Mullen,26,30,Tirelli,26,30,-3,-4,-4
2017-04-08,3,Blachowicz,Cummins,Cummins,Majority,Cleary,28,29,Crosby,28,28,D'Amato,28,29,-1,0,-1
2017-04-08,3,Green,Emmett,Green,Split,Crosby,29,28,D'Amato,30,27,Tirelli,28,29,1,3,-1
2017-04-08,3,Chookagian,Aldana,Chookagian,Split,Cleary,28,29,Colón,29,28,Mullen,29,28,-1,1,1
2017-04-08,3,Bibulatov,Lausa,Bibulatov,Unanimous,Cleary,29,26,Colón,29,26,Mullen,29,26,3,3,3
2017-04-07,3,Bienkowski,Chmielewski,Bienkowski,Unanimous,Bonkowski,30,28,Motylewski,30,28,Porebski,30,27,2,2,3
2017-04-07,3,Neves de Oliveira,Szymanski,Szymanski,Unanimous,Pawlega,25,30,Porebski,26,29,Wojciechowski,26,29,-5,-3,-3
2017-04-07,3,Azhiev,Selwa,Azhiev,Unanimous,Bonkowski,29,28,Motylewski,29,28,Porebski,29,28,1,1,1
2017-04-07,3,Szadzinski,Szymuszowski,Szymuszowski,Majority,Motylewski,28,28,Porebski,28,29,Wojciechowski,28,29,0,-1,-1
2017-04-07,3,Romanowski,Rajewski,Rajewski,Unanimous,Motylewski,28,29,Pawlega,28,29,Wojciechowski,28,29,-1,-1,-1
2017-04-01,5,Narimani,Pimblett,Narimani,Unanimous,Cartlidge,49,46,Collett,50,45,Lethaby,48,47,3,5,1
2017-04-01,3,Schuckman,McCann,McCann,Unanimous,Cartlidge,28,29,Collett,28,29,Lethaby,28,29,-1,-1,-1
2017-04-01,3,Manning,McBain,McBain,Split,Cartlidge,28,29,Collett,29,28,Lethaby,28,29,-1,1,-1
2017-03-31,3,Lawal,Jackson,Lawal,Unanimous,Cleary,29,28,D'Amato,29,28,Lee,29,28,1,1,1
2017-03-31,3,Galvão,Sanchez,Sanchez,Unanimous,Cleary,27,30,Lee,27,30,Puccillo,27,30,-3,-3,-3
2017-03-31,3,Buckley,Patterson,Buckley,Unanimous,Cleary,30,27,Lee,29,28,Mason,29,28,3,1,1
2017-03-31,3,Williams,Vazquez,Vazquez,Unanimous,Caldwell,28,29,D'Amato,27,30,Puccillo,27,29,-1,-3,-2
2017-03-31,3,Norris,Shoaff,Norris,Unanimous,Cleary,30,27,Lee,30,27,Mason,30,27,3,3,3
2017-03-31,3,DeLaViega,Akins,DeLaViega,Split,Cleary,29,28,Lee,28,29,Mason,29,28,1,-1,1
2017-03-25,3,Bennett,Esquibel,Esquibel,Split,Gueary,28,29,Marquez,28,29,Miller,29,28,-1,-1,1
2017-03-25,3,Cummins,Brown,Cummins,Unanimous,Gueary,29,28,Miller,29,28,Swanberg,30,27,1,1,3
2017-03-25,3,Martin,Davidsdottir,Davidsdottir,Unanimous,Gueary,27,30,Marquez,28,29,Swanberg,28,29,-3,-1,-1
2017-03-25,3,Spencer,McElhaney,Spencer,Unanimous,Marquez,30,27,Miller,29,28,Swanberg,30,27,3,1,3
2017-03-18,12,Golovkin,Jacobs,Golovkin,Unanimous,Deluca,114,113,Trella,115,112,Weisfeld,115,112,1,3,3
2017-03-18,12,Sor Rungvisai,González,Sor Rungvisai,Majority,Feldman,114,112,Lederman,114,112,Roldan,113,113,2,2,0
2017-03-18,3,Secor,Nurmagomedov,Nurmagomedov,Unanimous,Anderson,27,30,Bruce,27,30,Tirelli,28,29,-3,-3,-1
2017-03-18,3,Marcellino,Jones,Marcellino,Unanimous,Bruce,30,27,Colón,29,28,Peabody,30,27,3,1,3
2017-03-18,3,Dawodu,Siler,Dawodu,Unanimous,Bruce,30,27,Colón,30,26,Tirelli,29,28,3,4,1
2017-03-18,3,Rodriguez,Almeida,Rodriguez,Split,Bruce,30,27,Colón,29,28,Tirelli,28,29,3,1,-1
2017-03-18,3,Walo,Nakahara,Walo,Split,Anderson,29,28,Colón,28,29,Peabody,29,28,1,-1,1
2017-03-18,3,Amirkhani,Allen,Allen,Split,Collett,27,30,Hughes,29,28,Sutherland,27,30,-3,1,-3
2017-03-18,3,Duffy,Madadi,Duffy,Unanimous,Cartlidge,30,27,Harasim,30,27,Kobayashi,30,27,3,3,3
2017-03-18,3,Barroso,Stewart,Barroso,Unanimous,Collett,29,28,Hughes,29,28,Roberts,29,28,1,1,1
2017-03-18,3,Johnson,Omielanczuk,Johnson,Split,Cartlidge,30,27,Harasim,28,29,Kobayashi,29,28,3,-1,1
2017-03-18,3,Luque,Edwards,Edwards,Unanimous,Collett,28,29,Roberts,28,29,Sutherland,28,29,-1,-1,-1
2017-03-18,3,Askham,Scott,Scott,Split,Cartlidge,28,29,Kobayashi,28,29,Roberts,29,28,-1,-1,1
2017-03-18,3,Pudilova,Lansberg,Lansberg,Unanimous,Collett,28,29,Hughes,28,29,Sutherland,28,29,-1,-1,-1
2017-03-11,3,Formiga,Borg,Borg,Unanimous,Alves,28,29,D'Amato,28,29,Weeks,28,29,-1,-1,-1
2017-03-11,3,Ramos,Moraes,Moraes,Unanimous,Borges,27,30,Bravo,27,30,Weeks,27,30,-3,-3,-3
2017-03-11,3,Soto,Yahya,Soto,Unanimous,Alves,29,27,D'Amato,29,27,Weeks,29,28,2,2,1
2017-03-11,3,Kennedy,Jason,Kennedy,Unanimous,Alves,29,27,Borges,29,28,D'Amato,29,28,2,1,1
2017-03-11,3,Reneau,Correia,draw,Majority,Borges,29,27,Bravo,28,28,Weeks,28,28,2,0,0
2017-03-04,5,Clark,Moore,Moore,Unanimous,Cartlidge,45,49,Collett,44,50,Lethaby,42,50,-4,-6,-8
2017-03-04,3,McKenna,Costigan,Costigan,Split,Cartlidge,29,28,Collett,28,29,Lethaby,28,29,1,-1,-1
2017-03-04,3,McColgan,Quero,Quero,Split,Cartlidge,27,30,Collett,28,29,Lethaby,29,28,-3,-1,1
2017-03-04,3,Nolan,Zembala,Nolan,Unanimous,Cartlidge,30,26,Collett,29,27,Lethaby,29,27,4,2,2
2017-03-04,5,Woodley,Thompson,Woodley,Majority,Cleary,48,47,D'Amato,47,47,Lee,48,47,1,0,1
2017-03-04,3,Vannata,Teymur,Teymur,Unanimous,Kamijo,27,30,Mullen,27,30,Rosales,27,30,-3,-3,-3
2017-03-04,3,Evans,Kelly,Kelly,Split,Cleary,28,29,Hagen,28,29,Lee,29,28,-1,-1,1
2017-03-04,3,Spitz,Godbeer,Godbeer,Unanimous,Hagen,27,30,Morse Jarman,27,30,Mullen,27,30,-3,-3,-3
2017-03-04,3,Soukhamthath,Morales,Morales,Split,D'Amato,28,29,Hagen,28,29,Morse Jarman,29,28,-1,-1,1
2017-03-03,3,Gonzalez,Girtz,Gonzalez,Unanimous,Anderson,30,26,Sutherland,29,28,Turnage,29,27,4,1,2
2017-03-03,3,Rivera,Thomison,Rivera,Unanimous,Anderson,30,27,Montalvo,30,26,Turnage,30,27,3,4,3
2017-02-24,3,Razafiarison,Kavanagh,Razafiarison,Unanimous,Colón,30,27,Miner,30,26,Mullen,30,25,3,4,5
2017-02-19,3,Lombard,Hendricks,Hendricks,Unanimous,Earle,27,30,Macavoy,27,30,Robinson,28,29,-3,-3,-1
2017-02-19,3,Tucker,Sicilia,Tucker,Unanimous,Bridgeman,30,27,D'Amato,30,27,Smith,30,27,3,3,3
2017-02-19,3,Ferreira,Theodorou,Theodorou,Unanimous,Macavoy,27,30,Robinson,28,29,Smith,28,29,-3,-1,-1
2017-02-19,3,Taleb,Ponzinibbio,Ponzinibbio,Unanimous,Bridgeman,28,29,D'Amato,28,29,Smith,28,29,-1,-1,-1
2017-02-19,3,Markos,Esparza,Markos,Split,Earle,29,28,Macavoy,28,29,Robinson,29,28,1,-1,1
2017-02-19,3,Zahabi,Vieira,Zahabi,Unanimous,Bridgeman,29,28,D'Amato,29,28,Macavoy,30,27,1,1,3
2017-02-18,3,Stapleton,Dizy,Dizy,Unanimous,Cartlidge,27,29,Collett,27,29,Lethaby,26,30,-2,-2,-4
2017-02-18,3,Kongo,Thompson,Kongo,Unanimous,Guingona,30,26,Lee,30,25,Vierra,30,25,4,5,5
2017-02-18,3,Gonzalez,Jackson,Jackson,Unanimous,Rosales,27,30,Saucedo,27,30,Vierra,28,29,-3,-3,-1
2017-02-18,3,Llamas,Terry,Terry,Unanimous,Lee,28,30,Rosales,27,30,Vierra,27,30,-2,-3,-3
2017-02-18,3,Herzog,Sano,draw,Majority,Rosales,28,28,Saucedo,28,28,Vierra,28,27,0,0,1
2017-02-11,5,Holm,de Randamie,de Randamie,Unanimous,D'Amato,47,48,Lee,47,48,Mullen,47,48,-1,-1,-1
2017-02-11,3,Silva,Brunson,Silva,Unanimous,Cleary,29,28,Colón,30,27,Crosby,29,28,1,3,1
2017-02-11,3,Cannonier,Teixeira,Teixeira,Unanimous,Cleary,26,30,D'Amato,26,30,Lee,26,30,-4,-4,-4
2017-02-11,3,Miller,Poirier,Poirier,Majority,Cleary,28,29,Colón,28,28,Lee,27,30,-1,0,-3
2017-02-11,3,Muhammad,Brown,Muhammad,Unanimous,Crosby,30,27,D'Amato,30,27,Mullen,29,28,3,3,1
2017-02-11,3,Reis,Sasaki,Reis,Unanimous,Cleary,29,28,D'Amato,29,28,Mullen,29,28,1,1,1
2017-02-11,3,Makhachev,Lentz,Makhachev,Unanimous,Colón,30,25,Crosby,30,27,Lee,30,25,5,3,5
2017-02-11,3,Glenn,Nover,Glenn,Split,Cleary,29,28,Crosby,27,30,D'Amato,29,28,1,-3,1
2017-02-11,3,LaFlare,Carneiro,LaFlare,Unanimous,Colón,30,27,Lee,29,28,Mullen,30,26,3,1,4
2017-02-04,3,Grasso,Herrig,Herrig,Unanimous,Hancock,28,29,Mullen,28,29,Patlán,27,30,-1,-1,-3
2017-02-04,3,Oezdemir,Saint Preux,Oezdemir,Split,D'Amato,28,29,Ferraro,29,28,Soliz,29,28,-1,1,1
2017-02-04,3,Hill,Andrade,Andrade,Unanimous,D'Amato,27,30,Mullen,27,30,Patlán,27,30,-3,-3,-3
2017-02-04,3,Ramos,Tanaka,Ramos,Unanimous,Dealejandro,29,28,Ferraro,29,28,Soliz,30,27,1,1,3
2017-02-04,3,Torres,Rawlings,Torres,Unanimous,Ferraro,30,27,Hancock,30,27,Mullen,30,27,3,3,3
2017-01-28,3,Marquardt,Alvey,Alvey,Unanimous,D'Amato,28,29,Mann,28,29,Mullen,28,29,-1,-1,-1
2017-01-28,3,Sterling,Assuncao,Assuncao,Split,Hilsabeck,28,29,Mann,28,29,Ramirez,29,28,-1,-1,1
2017-01-28,3,Johnson,da Silva,Johnson,Unanimous,Garcia,30,27,Mann,30,27,Ramirez,30,27,3,3,3
2017-01-28,3,Pantoja,Shelton,Pantoja,Split,Garcia,29,28,Mann,28,29,Ramirez,29,28,1,-1,1
2017-01-27,3,Guillard,Njokuani,Njokuani,Unanimous,Champion,26,30,D'Amato,25,30,Hatley,24,30,-4,-5,-6
2017-01-27,3,Middleton,Yauger,Middleton,Unanimous,D'Amato,29,28,Danforth,30,26,Hatley,30,26,1,4,4
2017-01-27,3,Phillips,McKee,McKee,Unanimous,D'Amato,28,29,Divilbiss,27,30,Hatley,28,29,-1,-3,-1
2017-01-27,3,Young,Harris,Young,Unanimous,Champion,30,27,D'Amato,30,26,Hatley,30,27,3,4,3
2017-01-27,3,Ellen,James,Ellen,Unanimous,Champion,30,27,D'Amato,29,28,Hatley,30,27,3,1,3
2017-01-21,3,Kato,Gracie,Kato,Unanimous,Cleary,29,28,Crail,30,27,Mccarthy,29,28,1,3,1
2017-01-21,3,Karakhanyan,Sanchez,Sanchez,Majority,Bell,28,28,Cleary,27,28,Mccarthy,27,28,0,-1,-1
2017-01-21,3,Anderson,Campos,Campos,Unanimous,Cleary,28,29,Crail,28,29,Denkin,28,29,-1,-1,-1
2017-01-21,3,Brown,Soto,Soto,Unanimous,Cobian,28,29,Lebell,28,29,Mccarthy,28,29,-1,-1,-1
2017-01-21,3,Berry,Casey,draw,Majority,Bell,28,28,Cobian,27,29,Mccarthy,28,28,0,-2,0
2017-01-15,3,Lauzon,Held,Lauzon,Split,Cleary,27,30,Mullen,29,28,Rosales,29,28,-3,1,1
2017-01-15,3,Saunders,McGee,Saunders,Unanimous,Cleary,29,28,Flores,29,28,Rosales,29,28,1,1,1
2017-01-15,3,Pettis,Moraga,Pettis,Unanimous,Kamijo,29,28,Mullen,29,28,O'connell,30,27,1,1,3
2017-01-15,3,Powell,Klose,Klose,Unanimous,Cleary,27,30,Frank,27,30,Rosales,27,30,-3,-3,-3
2017-01-15,3,Mendes,Saenz,Mendes,Split,Flores,29,28,Frank,28,29,O'connell,29,28,1,-1,1
2017-01-15,3,White,Martin,Martin,Unanimous,Flores,27,30,Kamijo,27,30,Mullen,27,30,-3,-3,-3
2017-01-14,3,Eubanks,Ladd,Ladd,Unanimous,Champion,28,29,Gueary,27,30,Miller,27,30,-1,-3,-3
2017-01-14,3,Haga,Montenegro,Montenegro,Unanimous,Champion,28,29,Gueary,28,29,Miller,28,29,-1,-1,-1
2016-12-31,5,Shields,Fitch,Fitch,Unanimous,Carolei,46,49,Corrado,46,49,Tirelli,46,49,-3,-3,-3
2016-12-30,5,Garbrandt,Cruz,Garbrandt,Unanimous,Cleary,48,46,Mullen,48,46,Weeks,48,47,2,2,1
2016-12-30,3,Lineker,Dillashaw,Dillashaw,Unanimous,D'Amato,26,30,Hagen,26,30,Lee,26,30,-4,-4,-4
2016-12-30,3,Saffiedine,Kim,Kim,Split,Cleary,28,29,Mullen,28,29,Trowbridge,30,27,-1,-1,3
2016-12-30,3,Borg,Smolka,Borg,Unanimous,D'Amato,30,27,Lee,30,26,Rosales,30,26,3,4,4
2016-12-30,3,Magny,Hendricks,Magny,Unanimous,Cleary,29,28,Mullen,29,28,Weeks,29,28,1,1,1
2016-12-30,3,Vettori,Carlos Junior,Carlos Junior,Unanimous,D'Amato,28,29,Hagen,28,29,Rosales,28,29,-1,-1,-1
2016-12-17,3,Faber,Pickett,Faber,Unanimous,Cleary,30,26,D'Amato,30,26,Rosales,30,26,4,4,4
2016-12-17,3,Jouban,Perry,Jouban,Unanimous,Mccarthy,30,27,Saucedo,29,28,Vierra,30,27,3,1,3
2016-12-17,3,Hirota,Miller,Hirota,Unanimous,Cleary,30,26,Rosales,30,27,Saucedo,30,27,4,3,3
2016-12-17,3,Barberena,Covington,Covington,Unanimous,Cleary,27,30,Mccarthy,27,30,Vierra,27,30,-3,-3,-3
2016-12-17,3,Morono,Moontasri,Morono,Unanimous,Cleary,29,28,Guingona,29,28,Mccarthy,29,28,1,1,1
2016-12-17,3,Holtzman,Emmett,Emmett,Unanimous,Guingona,28,29,Saucedo,28,29,Vierra,28,29,-1,-1,-1
2016-12-17,3,Smith,Aldana,Smith,Unanimous,Guingona,29,28,Saucedo,30,27,Vierra,29,28,1,3,1
2016-12-17,3,Serrano,Sandoval,Sandoval,Unanimous,Guingona,28,29,Mccarthy,27,30,Saucedo,27,30,-1,-3,-3
2016-12-17,3,Velickovic,Aliev,Aliev,Split,Guingona,27,30,Mccarthy,27,30,Saucedo,29,28,-3,-3,1
2016-12-16,3,Ishii,Lawal,Lawal,Unanimous,Colón,27,30,Mullen,27,30,Tirelli,27,30,-3,-3,-3
2016-12-16,3,Kavanagh,Kallionidou,Kavanagh,Unanimous,Colón,30,25,Mullen,30,27,Tirelli,30,26,5,3,4
2016-12-10,3,Swanson,Choi,Swanson,Unanimous,Cleary,29,28,Colón,30,27,Crosby,30,27,1,3,3
2016-12-10,3,Meek,Mein,Meek,Unanimous,Procopio,29,28,Therien,29,28,Urso,29,28,1,1,1
2016-12-10,3,Létourneau,Pereira,Pereira,Split,Colón,28,29,Jackson,29,28,Urso,28,29,-1,1,-1
2016-12-10,3,Gagnon,Lopez,Lopez,Unanimous,Colón,27,29,Jackson,28,29,Urso,28,29,-2,-1,-1
2016-12-10,3,Khabilov,Saggo,Khabilov,Unanimous,Goulah,30,27,Procopio,30,27,Therien,30,27,3,3,3
2016-12-10,3,Ortiz,Makovsky,Ortiz,Split,Buckley,29,28,Procopio,29,28,Therien,28,29,1,1,-1
2016-12-09,3,Kish,Yoder,Kish,Unanimous,Carolei,29,28,Crosby,29,28,Urso,29,28,1,1,1
2016-12-09,3,Sanchez,Smith,Sanchez,Unanimous,Crosby,30,27,Trowbridge,30,27,Urso,30,27,3,3,3
2016-12-09,3,Trator,Burgos,Burgos,Unanimous,Carolei,28,29,Cleary,27,29,Crosby,26,30,-1,-2,-4
2016-12-09,3,Perez,Diakiese,Diakiese,Unanimous,Carolei,28,29,Trowbridge,28,29,Urso,28,29,-1,-1,-1
2016-12-09,3,Berish,Janes,Janes,Unanimous,Cleary,28,29,Crosby,28,29,Trowbridge,28,29,-1,-1,-1
2016-12-09,3,Aldrich,Lima,Lima,Unanimous,Carolei,27,30,Cleary,27,30,Urso,27,30,-3,-3,-3
2016-12-03,3,Maguire,Mankowski,Mankowski,Unanimous,Lethaby,25,30,Pawlega,26,30,Porebski,26,30,-5,-4,-4
2016-12-03,3,Neves de Oliveira,Wolanski,Wolanski,Split,Choinski,29,28,Porebski,27,30,Wojciechowski,27,30,1,-3,-3
2016-12-03,3,Caldwell,Taimanglo,Caldwell,Unanimous,Anderson,30,27,Mathisen,30,27,Sutherland,30,27,3,3,3
2016-12-03,3,Lawrence,Macapa,Macapa,Unanimous,Anderson,28,29,Sutherland,27,30,Turnage,27,30,-1,-3,-3
2016-12-03,3,Ducote,Macfarlane,Macfarlane,Unanimous,Anderson,27,30,Mathisen,28,29,Sutherland,28,29,-3,-1,-1
2016-12-03,3,Trice,Britton,Trice,Unanimous,Anderson,30,26,Mathisen,30,25,Turnage,28,28,4,5,0
2016-12-03,3,Ford,Patterson,Patterson,Unanimous,Anderson,28,29,Mathisen,28,29,Sutherland,27,29,-1,-1,-2
2016-12-03,3,Roberson,Gary,Gary,Unanimous,Mathisen,28,29,Sutherland,28,29,Turnage,28,29,-1,-1,-1
2016-12-03,5,Elliott,Johnson,Johnson,Unanimous,D'Amato,45,49,Kamijo,46,49,Mullen,46,49,-4,-3,-3
2016-12-03,3,Benavidez,Cejudo,Benavidez,Split,Cleary,29,27,Rosales,27,29,Trowbridge,30,26,2,-2,4
2016-12-03,3,Cutelaba,Cannonier,Cannonier,Unanimous,Cleary,28,29,Kamijo,28,29,Rosales,28,29,-1,-1,-1
2016-12-03,3,Benoit,Moreno,Moreno,Split,Kamijo,28,29,Mullen,28,29,Winter,29,28,-1,-1,1
2016-12-03,3,Maynard,Hall,Hall,Unanimous,Cleary,27,30,Morse Jarman,27,30,Trowbridge,28,29,-3,-3,-1
2016-12-03,3,Ma,O'Reilly,Ma,Unanimous,D'Amato,29,28,Trowbridge,29,28,Winter,29,28,1,1,1
2016-12-03,3,Moyle,Curran,Moyle,Unanimous,Cleary,30,27,Morse Jarman,30,27,Weeks,30,27,3,3,3
2016-12-03,3,Clark,Stansbury,Clark,Unanimous,Morse Jarman,30,27,Weeks,30,27,Winter,29,28,3,3,1
2016-12-02,5,Dantas,Warren,Dantas,Majority,Anderson,49,44,Mathisen,48,46,Montalvo,47,47,5,2,0
2016-12-02,3,McKee,Wood,McKee,Unanimous,Anderson,29,27,Armstrong,30,27,Mathisen,30,25,2,3,5
2016-12-02,3,Davis,Galvão,Galvão,Split,Anderson,28,29,Mathisen,28,29,Montalvo,29,28,-1,-1,1
2016-12-02,3,Honeycutt,Reiter,Honeycutt,Unanimous,Anderson,30,26,Armstrong,30,25,Mathisen,30,25,4,5,5
2016-12-02,3,Spotwood,King,Spotwood,Unanimous,Anderson,30,27,Mathisen,29,28,Montalvo,30,27,3,1,3
2016-11-27,3,Holbrook,Matthews,Holbrook,Split,Dimitriou,29,28,Field,29,28,Keech,28,29,1,1,-1
2016-11-27,3,Akhmedov,Noke,Akhmedov,Unanimous,Field,29,28,Foley,29,28,Shen,30,27,1,1,3
2016-11-27,3,Ham,Taylor,Taylor,Split,Dimitriou,27,30,Field,27,30,Shen,29,28,-3,-3,1
2016-11-27,3,Kelly,Camozzi,Kelly,Unanimous,Foley,29,28,Keech,30,27,Shen,29,28,1,3,1
2016-11-27,3,Tuck,Brown,Brown,Split,Dimitriou,28,29,Field,28,29,Shen,29,28,-1,-1,1
2016-11-27,3,Walsh,Meunier,Meunier,Unanimous,Cartlidge,28,29,Dimitriou,27,30,Shen,27,30,-1,-3,-3
2016-11-27,3,Nguyen,Herrera,Nguyen,Unanimous,Cartlidge,30,26,Foley,30,27,Shen,30,27,4,3,3
2016-11-27,3,Hooker,Knight,Knight,Unanimous,Field,27,30,Keech,26,30,Shen,28,29,-3,-4,-1
2016-11-27,3,Vera,Ning,Vera,Unanimous,Foley,29,28,Keech,29,28,Shen,29,28,1,1,1
2016-11-27,3,Lausa,Zhikui,Lausa,Unanimous,Cartlidge,30,27,Dimitriou,30,27,Field,30,27,3,3,3
2016-11-19,3,Casey,Gadelha,Gadelha,Unanimous,Alves,27,30,Pontes,27,30,Terrell,27,30,-3,-3,-3
2016-11-19,3,Leites,Jotko,Jotko,Unanimous,Colón,27,29,Pontes,27,30,Terrell,27,30,-2,-3,-3
2016-11-19,3,Usman,Alves,Usman,Unanimous,Alves,30,26,Bravo,29,27,Colón,29,28,4,2,1
2016-11-19,3,Moraes,Ottow,Moraes,Split,Bravo,30,27,Pontes,28,29,Terrell,30,27,3,-1,3
2016-11-19,3,Gonzalez,Lujan,Lujan,Split,Bell,28,29,Guingona,30,27,Mccarthy,28,29,-1,3,-1
2016-11-19,3,Labiano,Murdock,Labiano,Unanimous,Bell,30,27,Cleary,30,27,Mccarthy,30,27,3,3,3
2016-11-19,5,Henderson,Chandler,Chandler,Split,Bell,46,48,Cleary,47,48,Mccarthy,48,46,-2,-1,2
2016-11-19,3,Gonzalez,Page,Page,Split,Bell,28,29,Guingona,30,27,Mccarthy,28,29,-1,3,-1
2016-11-19,3,Piccolotti,Girtz,Piccolotti,Unanimous,Bray,29,28,Cleary,29,28,Thomas-Gitlin,29,28,1,1,1
2016-11-19,3,Vassell,Carmont,Vassell,Unanimous,Bell,30,25,Cleary,30,26,Mccarthy,30,26,5,4,4
2016-11-19,3,Roberts,Banks,Banks,Unanimous,Bell,28,29,Cleary,27,30,Mccarthy,27,30,-1,-3,-3
2016-11-19,3,Mohammed,Grant,Grant,Unanimous,Bray,26,30,Cleary,27,30,Thomas-Gitlin,26,30,-4,-3,-4
2016-11-19,3,Pearson,Ray,Ray,Split,Grüner,30,27,Harasim,27,30,Kobayashi,27,30,3,-3,-3
2016-11-19,3,Johnson,Volkov,Volkov,Split,Hughes,28,29,Kobayashi,28,29,Lavery,30,27,-1,-1,3
2016-11-19,3,Lobov,Ishihara,Lobov,Unanimous,Collett,30,27,Harasim,30,27,Lavery,29,28,3,3,1
2016-11-19,3,Horiguchi,Bagautinov,Horiguchi,Unanimous,Grüner,30,27,Harasim,30,27,Sutherland,30,27,3,3,3
2016-11-19,3,Elmose,Cooper,Cooper,Unanimous,Hughes,28,29,Lavery,27,30,Sutherland,28,29,-1,-3,-1
2016-11-19,3,Kwak,Johns,Johns,Unanimous,Grüner,27,30,Harasim,27,30,Hughes,27,30,-3,-3,-3
2016-11-19,12,Kovalev,Ward,Ward,Unanimous,Clements,113,114,Mckaie,113,114,Trowbridge,113,114,-1,-1,-1
2016-11-18,5,Medeiros,Hill,Hill,Unanimous,Champion,46,49,Gueary,47,48,Swanberg,45,50,-3,-1,-5
2016-11-18,3,Soukupova,Tiburcio,Tiburcio,Unanimous,Champion,28,29,Gueary,28,29,Marquez,28,29,-1,-1,-1
2016-11-18,3,Clark,Sorenson,Sorenson,Split,Gueary,27,30,Marquez,27,30,Swanberg,29,28,-3,-3,1
2016-11-18,3,Alvarez,Aldrich,Aldrich,Unanimous,Champion,27,30,Gueary,27,30,Swanberg,27,30,-3,-3,-3
2016-11-18,3,Egger,Conners,Conners,Split,Champion,28,29,Gueary,29,28,Marquez,28,29,-1,1,-1
2016-11-12,5,Jedrzejczyk,Kowalkiewicz,Jedrzejczyk,Unanimous,Lee,49,46,Mullen,49,46,Urso,49,46,3,3,3
2016-11-12,3,Pennington,Tate,Pennington,Unanimous,Cleary,30,27,Crosby,29,28,Mullen,30,27,3,1,3
2016-11-12,3,Stephens,Edgar,Edgar,Unanimous,D'Amato,28,29,Trowbridge,27,30,Urso,27,30,-1,-3,-3
2016-11-12,3,Alves,Miller,Miller,Unanimous,Lee,27,30,Mullen,27,30,Urso,28,29,-3,-3,-1
2016-11-12,3,Chookagian,Carmouche,Carmouche,Split,Lee,28,29,Trowbridge,29,28,Urso,28,29,-1,1,-1
2016-11-12,5,Erosa,Pimblett,Pimblett,Unanimous,Cartlidge,47,48,Lethaby,47,48,Sledge,46,49,-1,-1,-3
2016-11-12,5,Herron-Webb,Fishgold,Fishgold,Unanimous,Cartlidge,47,48,Lethaby,47,48,Sledge,47,48,-1,-1,-1
2016-11-12,3,Creasey,Haque,Haque,Unanimous,Cartlidge,26,30,Lethaby,27,29,Sledge,27,30,-4,-2,-3
2016-11-12,5,Thompson,Woodley,draw,Majority,Cleary,47,47,Crosby,47,47,Trowbridge,47,48,0,0,-1
2016-11-11,3,Benitez,Ovchynnikova,Ovchynnikova,Unanimous,Miner,27,30,Mullen,27,30,Sanidad,27,30,-3,-3,-3
2016-11-05,5,dos Anjos,Ferguson,Ferguson,Unanimous,Cleary,47,48,Lee,47,48,Rosales,47,48,-1,-1,-1
2016-11-05,3,Sanchez,Held,Sanchez,Unanimous,D'Amato,29,28,Lee,29,27,Puccillo,29,28,1,2,1
2016-11-05,3,Magomedov,Dariush,Dariush,Unanimous,Cleary,27,30,D'Amato,27,30,Lee,28,29,-3,-3,-1
2016-11-05,3,Grasso,Clark,Grasso,Unanimous,Cleary,30,27,Lee,30,27,Puccillo,29,28,3,3,1
2016-11-05,3,Arantes,Perez,Perez,Split,D'Amato,28,29,Mullen,28,29,Rosales,29,28,-1,-1,1
2016-11-05,3,Alvey,Nicholson,Alvey,Unanimous,Cleary,29,28,Lee,29,28,Puccillo,29,28,1,1,1
2016-11-05,3,Reyes,Novelli,Reyes,Split,Mullen,29,28,Puccillo,29,28,Rosales,28,29,1,1,-1
2016-11-05,3,Avila,Barzola,Barzola,Unanimous,Cleary,26,30,D'Amato,26,30,Lee,26,30,-4,-4,-4
2016-11-04,5,McGeary,Davis,Davis,Unanimous,Colón,43,50,Miner,44,50,Sanidad,45,50,-7,-6,-5
2016-11-04,3,Correia,Kotau,Correia,Split,Macdonald,30,27,Miner,30,27,Sanidad,28,29,3,3,-1
2016-10-21,3,Wessel,Tate,Wessel,Unanimous,Lee,29,28,Maness,29,28,Ziemba,29,28,1,1,1
2016-10-21,3,Willis,Johnson,Willis,Unanimous,Cleary,29,28,Lee,29,26,Mullen,29,27,1,3,2
2016-10-21,3,Brents,Gormley,Gormley,Split,Cleary,29,28,Lee,28,29,Maness,28,29,1,-1,-1
2016-10-21,3,Budd,Blencowe,Budd,Majority,Lee,29,27,Maness,29,29,Ziemba,30,27,2,0,3
2016-10-21,3,Smith,Rainey,Rainey,Unanimous,Lee,28,29,Maness,28,29,Mullen,28,29,-1,-1,-1
2016-10-21,3,Garcia,Lawrence,Garcia,Unanimous,Cleary,30,27,Mullen,29,28,Ziemba,30,27,3,1,3
2016-10-15,3,Sheridan,Reed,Reed,Split,Cartlidge,30,27,Jones,28,29,Lethaby,28,29,3,-1,-1
2016-10-15,3,Hartman,Wells,Wells,Unanimous,Cartlidge,27,30,Jones,27,30,Lethaby,27,30,-3,-3,-3
2016-10-08,5,Bisping,Henderson,Bisping,Unanimous,Grüner,48,47,Mullen,48,47,Roberts,49,46,1,1,3
2016-10-08,3,Santos,Martins,Santos,Split,Motylewski,28,29,Mullen,29,28,Sutherland,29,28,-1,1,1
2016-10-07,3,Howard,Nurmagomedov,Nurmagomedov,Unanimous,Gueary,28,29,Miller,28,29,Swanberg,27,30,-1,-1,-3
2016-10-07,3,Gutierrez,Valiev,Valiev,Unanimous,Danforth,27,30,Gueary,28,29,Miller,27,30,-3,-1,-3
2016-10-07,3,Magomedov,Brock,Magomedov,Unanimous,Danforth,29,28,Miller,30,27,Swanberg,29,28,1,3,1
2016-10-07,3,Azaitar,Arrant,Azaitar,Unanimous,Gueary,30,27,Miller,30,27,Swanberg,30,27,3,3,3
2016-10-07,3,Cooper,Magomedkerimov,Magomedkerimov,Split,Danforth,29,28,Gueary,27,30,Swanberg,27,30,1,-3,-3
2016-10-01,5,Dodson,Lineker,Lineker,Split,D'Amato,47,48,Rosales,48,47,Trowbridge,47,48,-1,1,-1
2016-10-01,3,Burkman,Ottow,Ottow,Split,D'Amato,28,29,Mullen,28,29,Trowbridge,29,28,-1,-1,1
2016-10-01,3,Fili,Dias,Fili,Unanimous,Hagen,29,28,Rosales,29,28,Trowbridge,29,28,1,1,1
2016-10-01,3,Abdurakhimov,Harris,Abdurakhimov,Split,D'Amato,29,28,Hagen,29,28,Rosales,28,29,1,1,-1
2016-10-01,3,Nakamura,Zaleski dos Santos,Zaleski dos Santos,Unanimous,Campos,28,29,Mullen,28,29,Trowbridge,28,29,-1,-1,-1
2016-10-01,3,Wilson,Cutelaba,Cutelaba,Unanimous,Campos,27,30,D'Amato,27,30,Mullen,27,30,-3,-3,-3
2016-10-01,3,Vieira,Faszholz,Vieira,Split,Campos,29,28,D'Amato,29,28,Mullen,28,29,1,1,-1
2016-10-01,3,Lubonska,Belbita,Belbita,Unanimous,Lethaby,27,30,Porebski,27,30,Stanczuk,27,30,-3,-3,-3
2016-10-01,3,Szulakowski,Kurczewski,Szulakowski,Unanimous,Cartlidge,30,27,Pawlega,30,27,Stanczuk,30,27,3,3,3
2016-10-01,3,Mazur,Kazieczko,Kazieczko,Unanimous,Porebski,27,30,Stanczuk,27,30,Wojciechowski,27,30,-3,-3,-3
2016-09-24,3,Nover,Barão,Barão,Unanimous,Bravo,28,29,D'Amato,28,29,Terrell,27,30,-1,-1,-3
2016-09-24,3,Prazeres,Burns,Prazeres,Unanimous,Bravo,30,27,Pontes,30,27,Terrell,30,27,3,3,3
2016-09-24,3,Yahya,Tanaka,Yahya,Unanimous,Alves,29,28,Borges,29,28,Pontes,29,28,1,1,1
2016-09-24,3,Ortiz,Formiga,Formiga,Unanimous,Bravo,28,29,D'Amato,27,29,Terrell,27,30,-1,-2,-3
2016-09-24,3,Ray,Patrick,Patrick,Unanimous,Alves,28,29,Bravo,27,30,Terrell,28,29,-1,-3,-1
2016-09-24,3,Gillespie,França,Gillespie,Unanimous,Alves,29,27,Bravo,29,27,D'Amato,29,27,2,2,2
2016-09-23,5,Modafferi,Maia,Maia,Split,Danforth,47,48,Miller,46,49,Swanberg,48,47,-1,-3,1
2016-09-23,3,Kolekar,Medeiros,Medeiros,Unanimous,Danforth,27,30,Marquez,27,30,Miller,28,29,-3,-3,-1
2016-09-23,3,Greenway,Davidsdottir,Davidsdottir,Unanimous,Danforth,27,30,Marquez,27,30,Miller,27,30,-3,-3,-3
2016-09-17,3,Glenn,Dunham,Dunham,Unanimous,Beltran,27,30,Chapa,27,30,Maldonado,27,30,-3,-3,-3
2016-09-17,3,Robertson,Carneiro,Carneiro,Split,Chapa,29,28,Maldonado,27,30,Rosales,28,29,1,-3,-1
2016-09-17,3,Makhachev,Wade,Makhachev,Unanimous,Beltran,29,28,Chapa,29,28,Maldonado,29,28,1,1,1
2016-09-17,3,Gomez,Quinonez,Quinonez,Unanimous,Beltran,28,29,Chapa,27,30,Maldonado,27,30,-1,-3,-3
2016-09-17,3,Morales,Perez,draw,Majority,Beltran,28,28,Chapa,29,27,Rosales,28,28,0,2,0
2016-09-16,3,Kongo,Johnson,Kongo,Majority,D'Amato,28,28,Schorle,29,28,Townsend,29,28,0,1,1
2016-09-16,3,Arteaga,Yankova,Yankova,Split,Schorle,28,29,Stafin,29,28,Townsend,28,29,-1,1,-1
2016-09-16,3,Chan,Campos,Campos,Unanimous,D'Amato,28,29,Hillin,28,29,Medellin,28,29,-1,-1,-1
2016-09-16,3,Gonzalez,Stewart,Gonzalez,Split,Schorle,29,28,Stafin,28,29,Townsend,29,28,1,-1,1
2016-09-16,3,Clements,Ramirez,Clements,Unanimous,Schorle,30,27,Stafin,30,26,Townsend,30,27,3,4,3
2016-09-16,3,Mazurek,Guerra,Mazurek,Split,Schorle,28,29,Stafin,29,28,Townsend,30,27,-1,1,3
2016-09-10,3,Wilde,Lebout,Wilde,Unanimous,Cartlidge,29,27,Lethaby,29,28,Sledge,29,28,2,1,1
2016-09-10,3,Barnes,Cheng,Cheng,Unanimous,Cartlidge,27,30,Lethaby,28,29,Sledge,28,29,-3,-1,-1
2016-09-10,3,Miller,Hampson,Hampson,Unanimous,Cartlidge,28,29,Lethaby,28,29,Sledge,27,30,-1,-1,-3
2016-09-10,3,Browne,Werdum,Werdum,Unanimous,Barry,28,29,D'Amato,27,29,Winter,27,30,-1,-2,-3
2016-09-10,3,Faber,Rivera,Rivera,Unanimous,Cleary,27,30,D'Amato,27,30,Winter,27,30,-3,-3,-3
2016-09-10,3,Correia,Eye,Correia,Split,Cleary,29,28,Colón,29,28,D'Amato,28,29,1,1,-1
2016-09-10,3,Magalhães,Tavares,Tavares,Split,Cleary,27,30,Colón,28,29,Winter,29,28,-3,-1,1
2016-09-03,3,Blachowicz,Gustafsson,Gustafsson,Unanimous,Hughes,27,30,Sutherland,27,30,Werner,27,30,-3,-3,-3
2016-09-03,3,Hein,Bang,Hein,Unanimous,Collett,29,28,Hughes,30,27,Roberts,29,28,1,3,1
2016-09-03,3,Wallhead,Ayari,Ayari,Split,Cartlidge,29,28,Kobayashi,28,29,Sutherland,27,30,1,-1,-3
2016-09-03,3,Dalby,Sobotta,Sobotta,Unanimous,Collett,26,30,Hughes,26,30,Roberts,26,30,-4,-4,-4
2016-09-03,3,Lapilus,Issa,Lapilus,Unanimous,Collett,30,27,Hughes,29,28,Sutherland,30,27,3,1,3
2016-09-03,3,Hermansson,Askham,Hermansson,Unanimous,Cartlidge,30,27,Hughes,29,28,Sutherland,30,27,3,1,3
2016-09-03,3,Khabilov,Silva,Khabilov,Unanimous,Collett,29,28,Roberts,30,27,Werner,29,28,1,3,1
2016-09-03,3,Danho,Colombo,draw,Majority,Kobayashi,28,28,Roberts,27,29,Werner,28,28,0,-2,0
2016-08-27,3,Miller,Lauzon,Miller,Split,Hagen,28,29,Therien,29,28,Weeks,29,28,-1,1,1
2016-08-27,3,Barzola,Bochniak,Bochniak,Split,Cooper,28,29,Hagen,28,29,Therien,30,27,-1,-1,3
2016-08-27,3,McLellan,Di Chirico,Di Chirico,Split,Cooper,28,29,Therien,28,29,Weeks,29,28,-1,-1,1
2016-08-27,3,Kennedy,Ricci,Kennedy,Unanimous,Cadlick,30,27,D'Amato,29,28,Therien,30,27,3,1,3
2016-08-26,3,Anderson,Awad,Anderson,Unanimous,Bell,29,28,Crail,29,28,Mccarthy,30,27,1,1,3
2016-08-26,3,Davis,Cutrone,Davis,Unanimous,Bell,30,27,Crail,30,27,Mccarthy,30,27,3,3,3
2016-08-26,3,Murad,Cisneros,Murad,Unanimous,Crail,29,28,Mccarthy,29,28,Polos,29,28,1,1,1
2016-08-26,3,Rosales,Segura,Rosales,Unanimous,Bell,29,28,Crail,30,27,Polos,29,28,1,3,1
2016-08-20,5,Diaz,McGregor,McGregor,Majority,Cleary,47,48,Mullen,47,48,Trowbridge,47,47,-1,-1,0
2016-08-20,3,Phillips,Pennington,Pennington,Unanimous,Byrd,27,30,Mullen,27,30,Weeks,27,30,-3,-3,-3
2016-08-20,3,Avila,Lobov,Lobov,Unanimous,Cleary,27,30,Hagen,27,30,Silbert,27,30,-3,-3,-3
2016-08-06,5,Caceres,Rodriguez,Rodriguez,Split,Cleary,49,46,Trowbridge,47,48,Weeks,47,48,3,-1,-1
2016-08-06,3,Jason,Bermudez,Bermudez,Unanimous,Cleary,27,30,Montanez,27,30,Trowbridge,26,30,-3,-3,-4
2016-08-06,3,Ponzinibbio,Cummings,Ponzinibbio,Unanimous,Cleary,30,27,Mcmahon,29,28,Weeks,29,28,3,1,1
2016-08-06,3,Gigliotti,Smith,Smith,Unanimous,Mcmahon,26,30,Trowbridge,26,30,Weeks,26,30,-4,-4,-4
2016-08-06,3,Moroz,Taylor,Moroz,Split,Cleary,29,28,Furse,28,29,Montanez,30,27,1,-1,3
2016-08-06,3,McGee,Steele,McGee,Unanimous,Cleary,29,28,Trowbridge,29,28,Weeks,30,27,1,1,3
2016-08-06,3,Kawajiri,Swanson,Swanson,Unanimous,Dutcher,28,29,Furse,27,30,Weeks,27,30,-1,-3,-3
2016-08-06,3,Sherman,Ledet,Ledet,Unanimous,Cleary,27,30,Dutcher,27,30,Mcmahon,27,30,-3,-3,-3
2016-07-30,3,Namajunas,Kowalkiewicz,Kowalkiewicz,Split,Coffey,28,29,Lee,29,28,Mullen,28,29,-1,1,-1
2016-07-30,3,Perez,Rivera,Perez,Unanimous,Cleary,29,28,Lee,30,26,Marigliano,30,26,1,4,4
2016-07-30,3,Serrano,Benoit,Benoit,Split,Coffey,28,29,Corbett,28,29,Lee,29,28,-1,-1,1
2016-07-30,3,Masvidal,Pearson,Masvidal,Unanimous,Coffey,29,28,Marigliano,29,28,Mullen,30,27,1,1,3
2016-07-30,5,Almeida,Palmer,Palmer,Majority,Boehlke,46,49,Fields,48,48,Roy,45,50,-3,0,-5
2016-07-30,3,Fodor,Fodor,Fodor,Unanimous,Fields,30,26,Perry,30,26,Roy,30,26,4,4,4
2016-07-30,3,Harris,Salchow,Harris,Unanimous,Boehlke,30,27,Fields,30,27,Roy,30,27,3,3,3
2016-07-30,3,Graves,Velickovic,draw,Majority,Cleary,28,28,Corbett,30,27,Mullen,28,28,0,3,0
2016-07-29,3,Grasso,Esquibel,Grasso,Unanimous,Gueary,30,27,Miller,30,26,Swanberg,30,27,3,4,3
2016-07-29,3,Stanley,Niedzwiedz,Niedzwiedz,Unanimous,Danforth,27,30,Gueary,27,30,Miller,27,30,-3,-3,-3
2016-07-29,3,Simpson,Soukupova,Simpson,Unanimous,Danforth,29,28,Gueary,29,27,Miller,29,28,1,2,1
2016-07-23,5,Holm,Shevchenko,Shevchenko,Unanimous,D'Amato,46,49,Puccillo,46,49,Winter,46,49,-3,-3,-3
2016-07-23,3,Barboza,Melendez,Barboza,Unanimous,D'Amato,30,27,Puccillo,29,28,Winter,30,27,3,1,3
2016-07-23,3,Pepey,Elkins,Elkins,Unanimous,Mason,26,30,Sabaitis,27,29,Winter,27,29,-4,-2,-2
2016-07-23,3,Usman,Yakovlev,Usman,Unanimous,Mason,30,25,Sabaitis,30,25,Winter,30,25,5,5,5
2016-07-23,3,Cottrell,Prazeres,Prazeres,Unanimous,D'Amato,27,30,Mason,26,30,Puccillo,27,30,-3,-4,-3
2016-07-23,3,Oliveira,Moontasri,Oliveira,Unanimous,D'Amato,30,25,Mason,30,26,Puccillo,30,26,5,4,4
2016-07-23,3,Alers,Knight,Knight,Split,Janecek,28,29,Sabaitis,28,29,Winter,29,28,-1,-1,1
2016-07-22,3,Phillips,Willis,Phillips,Unanimous,Divilbiss,30,27,Malott,30,27,Smith,30,27,3,3,3
2016-07-22,3,Sanchez,Weichel,Weichel,Split,Malott,27,30,Mccarthy,28,29,Smith,30,27,-3,-1,3
2016-07-22,3,Ellen,Middleton,Middleton,Unanimous,Champion,28,29,Divilbiss,28,29,Smith,28,29,-1,-1,-1
2016-07-22,3,Navarro,Martinez,Martinez,Split,Champion,29,28,Divilbiss,28,29,Malott,28,29,1,-1,-1
2016-07-16,3,Daley,Lima,Lima,Unanimous,D'Amato,27,30,Hughes,27,30,Lee,27,30,-3,-3,-3
2016-07-16,3,Cutting,Gallagher,Gallagher,Unanimous,Cartlidge,27,30,D'Amato,27,30,Hughes,27,30,-3,-3,-3
2016-07-16,3,Reid,Garcia,Garcia,Unanimous,Gerold,27,30,Hughes,27,30,Lee,26,30,-3,-3,-4
2016-07-16,3,Grove,Mulheron,Mulheron,Unanimous,Cartlidge,26,30,D'Amato,27,30,Lee,28,29,-4,-3,-1
2016-07-16,3,Tosta,Garnett,draw,Majority,D'Amato,28,28,Hughes,29,27,Lee,28,28,0,2,0
2016-07-13,3,Omielanczuk,Oleinik,Omielanczuk,Majority,Cleary,29,28,Ruml,28,28,Winter,29,28,1,0,1
2016-07-13,3,Murphy,Chookagian,Chookagian,Unanimous,D'Amato,28,29,Mullen,28,29,Ruml,28,29,-1,-1,-1
2016-07-13,3,Holtzman,Pfister,Holtzman,Unanimous,Allstot,30,27,Cleary,30,27,Winter,29,28,3,3,1
2016-07-09,3,Lesnar,Hunt,Lesnar,Unanimous,Griffin,29,27,Kamijo,29,27,Rosales,29,27,2,2,2
2016-07-09,3,Silva,Cormier,Cormier,Unanimous,Cleary,26,30,D'Amato,26,30,Trowbridge,26,30,-4,-4,-4
2016-07-09,5,Edgar,Aldo,Aldo,Unanimous,Cleary,46,49,Kamijo,47,48,Rosales,46,49,-3,-1,-3
2016-07-09,3,Zingano,Pena,Pena,Unanimous,Lee,28,29,Rosales,28,29,Trowbridge,28,29,-1,-1,-1
2016-07-09,3,Hendricks,Gastelum,Gastelum,Unanimous,Byrd,27,30,Cleary,27,30,D'Amato,28,29,-3,-3,-1
2016-07-09,3,Dillashaw,Assuncao,Dillashaw,Unanimous,Kamijo,30,27,Lee,30,27,Mullen,30,27,3,3,3
2016-07-09,3,Marin,Northcutt,Northcutt,Unanimous,Byrd,28,29,Cleary,28,29,Trowbridge,28,29,-1,-1,-1
2016-07-08,3,Lee,Deh,Deh,Unanimous,Cartlidge,28,29,Mitchell,28,29,Sledge,28,29,-1,-1,-1
2016-07-08,5,Jedrzejczyk,Gadelha,Jedrzejczyk,Unanimous,Hagen,48,45,Mullen,48,46,Rosales,48,46,3,2,2
2016-07-08,3,Rountree Jr.,Sanchez,Sanchez,Unanimous,Cleary,25,30,D'Amato,25,30,Lee,26,30,-5,-5,-4
2016-07-08,3,Pearson,Brooks,Brooks,Unanimous,Cleary,28,29,D'Amato,28,29,Morse Jarman,28,29,-1,-1,-1
2016-07-08,3,Maynard,Bruno,Maynard,Unanimous,Morse Jarman,30,27,Rosales,30,27,Trowbridge,30,27,3,3,3
2016-07-08,3,Nicolau,Moraga,Nicolau,Split,Griffin,29,28,Lee,29,28,Mullen,28,29,1,1,-1
2016-07-08,3,Hendricks,Stansbury,Stansbury,Majority,Cleary,27,29,Hagen,28,28,Morse Jarman,27,29,-2,0,-2
2016-07-08,3,Smith,Ferreira,Ferreira,Unanimous,Griffin,28,29,Lee,28,29,Trowbridge,28,29,-1,-1,-1
2016-07-07,3,Lewis,Nelson,Lewis,Split,Byrd,28,29,Hagen,29,28,Trowbridge,29,28,-1,1,1
2016-07-07,3,Muhammad,Jouban,Jouban,Unanimous,Cleary,27,29,D'Amato,27,28,Weeks,28,29,-2,-1,-1
2016-07-07,3,Makdessi,Baghdad,Makdessi,Split,D'Amato,28,29,Kamijo,29,28,Weeks,29,28,-1,1,1
2016-07-07,3,Lopes,Birchak,Birchak,Split,Cleary,28,29,Griffin,30,27,Morse Jarman,28,29,-1,3,-1
2016-06-24,3,Jackson,Ishii,Jackson,Split,D'Amato,29,28,Swanberg,28,29,Veale,30,27,1,-1,3
2016-06-18,5,MacDonald,Thompson,Thompson,Unanimous,D'Amato,47,48,Lee,45,50,Therien,45,50,-1,-5,-5
2016-06-18,3,Bossé,O'Connell,Bossé,Unanimous,D'Amato,29,27,Lee,29,28,Therien,29,28,2,1,1
2016-06-18,3,Silva,Saggo,Saggo,Split,Crosby,28,29,Procopio,28,29,Therien,29,28,-1,-1,1
2016-06-18,3,Theodorou,Alvey,Theodorou,Unanimous,Bettes,30,27,D'Amato,29,28,Therien,30,27,3,1,3
2016-06-18,3,Jones-Lybarger,Markos,Markos,Unanimous,Bettes,27,30,D'Amato,28,29,Therien,28,29,-3,-1,-1
2016-06-18,3,Bagautinov,Herrera,Bagautinov,Unanimous,Beauchamp,30,27,Crosby,30,27,Procopio,30,27,3,3,3
2016-06-17,3,Emelianenko,Maldonado,Emelianenko,Majority,Gorokhov,29,28,Gribkov,29,28,Makhmutova,28,28,1,1,0
2016-06-17,3,Tobar,Jauregui,Jauregui,Unanimous,Belardo,27,30,Bray,27,30,Saucedo,27,30,-3,-3,-3
2016-06-17,3,Smith,Bustamante,Bustamante,Majority,Bray,28,28,Saucedo,27,29,Vierra,27,29,0,-2,-2
2016-06-17,3,Buron,Ruiz,Ruiz,Split,Belardo,27,30,Rosales,29,28,Saucedo,27,30,-3,1,-3
2016-06-17,5,Dantas,Galvão,Dantas,Unanimous,Bray,50,43,Rosales,50,45,Vieira,50,44,7,5,6
2016-06-17,3,Parlo,Honeycutt,Honeycutt,Unanimous,Bray,28,29,Saucedo,27,30,Vierra,27,30,-1,-3,-3
2016-06-17,3,Reiter,Matthews,Reiter,Unanimous,Bray,30,26,Rosales,30,26,Saucedo,30,26,4,4,4
2016-06-17,3,Banks,Keith,Banks,Unanimous,Belardo,30,26,Bray,30,25,Vierra,30,26,4,5,4
2016-06-17,5,Ivanov,Copeland,Ivanov,Unanimous,Colón,49,46,Sanidad,49,46,Tirelli,48,47,3,3,1
2016-06-17,3,Howard,Arrant,Howard,Unanimous,Colón,30,27,Peabody,30,27,Sanidad,30,27,3,3,3
2016-06-17,3,Moraes,Palomino,Moraes,Unanimous,Peabody,29,28,Sanidad,29,28,Tirelli,29,28,1,1,1
2016-06-17,3,Marcellino,Powell,Powell,Split,Colón,28,29,Peabody,30,27,Tirelli,28,29,-1,3,-1
2016-06-17,3,Boyington,Almeida,Boyington,Split,Colón,27,30,Peabody,29,28,Sanidad,29,28,-3,1,1
2016-06-04,3,Edwards,Creasey,Creasey,Unanimous,Cartlidge,27,30,Jones,28,29,Lethaby,27,30,-3,-1,-3
2016-06-04,5,Faber,Cruz,Cruz,Unanimous,Mccarthy,45,50,Mullen,45,50,Vierra,46,49,-5,-5,-3
2016-06-04,3,Holloway,Lamas,Holloway,Unanimous,Bell,30,27,Cleary,30,27,Vierra,30,27,3,3,3
2016-06-04,3,Caceres,Miller,Caceres,Unanimous,Bell,29,28,Mullen,30,27,Vierra,29,28,1,3,1
2016-06-04,3,Breese,Strickland,Strickland,Split,Bell,29,28,Mullen,28,29,Vierra,28,29,1,-1,-1
2016-06-04,3,Mutapcic,Casey,draw,Split,Cleary,28,28,Mccarthy,28,29,Rosales,29,28,0,-1,1
2016-05-29,3,Stephens,Barão,Stephens,Unanimous,Byrd,29,28,Kamijo,29,28,Rosales,29,28,1,1,1
2016-05-29,3,Story,Saffiedine,Story,Unanimous,D'Amato,29,28,Lee,30,27,Weeks,29,28,1,3,1
2016-05-29,3,Camozzi,Miranda,Camozzi,Unanimous,Kamijo,30,27,Morse Jarman,30,27,Rosales,30,27,3,3,3
2016-05-29,3,Masvidal,Larkin,Larkin,Split,Byrd,29,28,Hagen,28,29,Trowbridge,28,29,1,-1,-1
2016-05-29,3,Felder,Burkman,Felder,Unanimous,Lee,29,28,Rosales,29,28,Weeks,29,28,1,1,1
2016-05-29,3,McMann,Eye,McMann,Unanimous,D'Amato,30,27,Hagen,30,27,Kamijo,30,27,3,3,3
2016-05-29,3,Trujillo,Rinaldi,Trujillo,Unanimous,Lee,29,28,Morse Jarman,29,28,Trowbridge,29,28,1,1,1
2016-05-29,3,Caraway,Sterling,Caraway,Split,Byrd,28,29,Hagen,29,28,Weeks,29,28,-1,1,1
2016-05-27,3,Karaoglu,Khalidov,Khalidov,Majority,Cartlidge,28,28,Lethaby,28,29,Wojciechowski,28,29,0,-1,-1
2016-05-27,3,Gamrot,Barnaoui,Gamrot,Unanimous,Cartlidge,30,26,Lethaby,30,27,Wojciechowski,30,27,4,3,3
2016-05-27,3,Wolanski,Wrzosek,Wrzosek,Unanimous,Choinski,28,29,Pawlega,28,29,Wojciechowski,28,29,-1,-1,-1
2016-05-27,3,Moks,Radomski,Moks,Split,Choinski,30,27,Pawlega,28,29,Porebski,29,28,3,-1,1
2016-05-27,3,Chlewicki,Thomas,Chlewicki,Unanimous,Cartlidge,30,27,Pawlega,30,27,Porebski,30,27,3,3,3
2016-05-27,3,Wojcik,Fijalka,Wojcik,Unanimous,Cartlidge,30,27,Choinski,30,27,Lethaby,30,26,3,3,4
2016-05-27,3,Szymuszowski,Verzbickas,Szymuszowski,Unanimous,Lethaby,30,27,Pawlega,30,27,Wojciechowski,30,27,3,3,3
2016-05-20,3,Arteaga,Vandenburgh,Arteaga,Unanimous,Bell,29,27,French,29,28,Hinds,30,27,2,1,3
2016-05-20,3,Thometz,Tyler,Thometz,Unanimous,Bell,30,25,Hazelbaker,30,27,Hinds,30,25,5,3,5
2016-05-20,5,Manhoef,Carvalho,Carvalho,Split,Anderson,47,48,Bell,48,47,Hinds,47,48,-1,1,-1
2016-05-20,3,Karakhanyan,Curran,Curran,Unanimous,Bell,28,29,Hazelbaker,28,29,Hinds,28,29,-1,-1,-1
2016-05-20,3,Beltran,Gormley,Gormley,Split,Bell,29,28,Hazelbaker,28,29,Hinds,28,29,1,-1,-1
2016-05-20,3,Held,Jansen,Held,Unanimous,Anderson,30,27,Bell,29,28,Hinds,29,28,3,1,1
2016-05-20,3,Charles,Sakai,draw,Majority,Bell,28,28,French,30,26,Hinds,28,28,0,4,0
2016-05-14,3,Lawal,Davis,Davis,Unanimous,Bell,27,30,Cleary,28,29,Rosales,27,30,-3,-1,-3
2016-05-14,3,Labiano,San Diego,San Diego,Unanimous,Guingona,28,29,Rosales,28,29,Vierra,28,29,-1,-1,-1
2016-05-14,3,Childs,Spengler,Spengler,Unanimous,Guingona,28,29,Mccarthy,27,30,Vierra,27,30,-1,-3,-3
2016-05-14,3,Rua,Anderson,Rua,Split,Pontes,28,29,Terrell,29,28,Torriero,29,28,-1,1,1
2016-05-14,3,Barberena,Alves,Barberena,Unanimous,Pontes,29,28,Torriero,29,28,Weeks,29,28,1,1,1
2016-05-14,3,Trinaldo,Medeiros,Trinaldo,Unanimous,Pontes,30,26,Terrell,30,27,Trowbridge,29,26,4,3,3
2016-05-14,3,Lineker,Font,Lineker,Unanimous,Pontes,30,26,Torriero,29,28,Trowbridge,30,27,4,1,3
2016-05-14,3,Tukhugov,Moicano,Moicano,Split,Terrell,28,29,Trowbridge,28,29,Vieira,29,28,-1,-1,1
2016-05-14,3,Chagas,Moraes,draw,Split,Terrell,28,28,Vieira,29,28,Weeks,28,29,0,1,-1
2016-05-08,3,Clark,Kowalkiewicz,Kowalkiewicz,Unanimous,Collett,28,29,Lavery,28,29,Sutherland,27,30,-1,-1,-3
2016-05-08,3,Wade,Khabilov,Khabilov,Unanimous,Grüner,28,29,Motylewski,28,29,Sutherland,27,30,-1,-1,-3
2016-05-08,3,Tuck,Emmett,Emmett,Split,Cartlidge,28,29,Grüner,29,28,Motylewski,28,29,-1,1,-1
2016-05-08,3,Horiguchi,Seery,Horiguchi,Unanimous,Cartlidge,30,26,Grüner,30,27,Sutherland,30,27,4,3,3
2016-05-08,3,Edwards,Waters,Edwards,Unanimous,Collett,30,27,Lavery,30,27,Sutherland,30,27,3,3,3
2016-05-07,5,Schneider,Evinger,Evinger,Unanimous,Bell,44,50,Denkin,44,49,Mccarthy,44,50,-6,-5,-6
2016-05-07,5,Souza,Hill,Hill,Split,Bell,47,48,Denkin,47,48,Mccarthy,48,47,-1,-1,1
2016-05-07,3,Sinn,Stanley,Stanley,Unanimous,Bell,27,30,Denkin,27,30,Mccarthy,28,29,-3,-3,-1
2016-05-07,3,Beck,Ostovich,Ostovich,Split,Bell,29,28,Denkin,28,29,Mccarthy,28,29,1,-1,-1
2016-05-07,3,Conners,Howarth,Howarth,Split,Bell,29,28,Denkin,28,29,Mccarthy,28,29,1,-1,-1
2016-04-23,5,Saint Preux,Jones,Jones,Unanimous,D'Amato,44,50,Kamijo,45,50,Lee,45,50,-6,-5,-5
2016-04-23,3,Pettis,Barboza,Barboza,Unanimous,D'Amato,28,29,Rosales,28,29,Weeks,27,30,-1,-1,-3
2016-04-23,3,Whittaker,Natal,Whittaker,Unanimous,Cleary,30,27,Lee,30,27,Morse Jarman,29,28,3,3,1
2016-04-23,3,Kelades,Pettis,Pettis,Unanimous,D'Amato,27,30,Morse Jarman,27,30,Trowbridge,27,30,-3,-3,-3
2016-04-23,3,Steele,Roberts,Roberts,Unanimous,Lee,28,29,Rosales,28,29,Weeks,28,29,-1,-1,-1
2016-04-23,3,Esparza,Lima,Esparza,Unanimous,Cleary,30,27,Kamijo,30,27,Mullen,30,27,3,3,3
2016-04-23,3,França,Vick,Vick,Unanimous,D'Amato,28,29,Trowbridge,28,29,Weeks,27,30,-1,-1,-3
2016-04-23,3,Escudero,Lee,Lee,Unanimous,Kamijo,28,29,Lee,28,29,Morse Jarman,28,29,-1,-1,-1
2016-04-22,5,Henderson,Koreshkov,Koreshkov,Unanimous,Sanidad,45,50,Tirelli,45,50,Wincapaw,45,50,-5,-5,-5
2016-04-22,3,Primus,Santos,Primus,Split,English,28,29,Tirelli,29,28,Wincapaw,29,28,-1,1,1
2016-04-22,3,Honeycutt,Secor,Honeycutt,Unanimous,Mccarthy,30,27,Miner,30,25,Tirelli,30,27,3,5,3
2016-04-16,3,Namajunas,Torres,Namajunas,Unanimous,D'Amato,29,28,Silbert,29,28,Vannatta,29,28,1,1,1
2016-04-16,3,Dias,Swanson,Swanson,Unanimous,Cleary,28,29,D'Amato,28,29,Green,28,29,-1,-1,-1
2016-04-16,3,Correia,Pennington,Pennington,Split,D'Amato,28,29,Davis,29,28,Lee,28,29,-1,1,-1
2016-04-16,3,Ferreira,Bamgbose,Ferreira,Unanimous,D'Amato,29,27,Davis,29,28,Green,29,28,2,1,1
2016-04-15,3,Grimshaw,Pimblett,Pimblett,Unanimous,Cartlidge,27,30,Lethaby,27,30,Sledge,27,30,-3,-3,-3
2016-04-15,3,Dolog,Adetola,Dolog,Unanimous,Cartlidge,29,28,Lethaby,30,27,Sledge,30,27,1,3,3
2016-04-10,5,Rothwell,dos Santos,dos Santos,Unanimous,Cartlidge,45,50,Collett,45,50,Hughes,45,50,-5,-5,-5
2016-04-10,3,Tybura,Johnson,Johnson,Unanimous,Grüner,28,29,Hughes,28,29,Kobayashi,28,29,-1,-1,-1
2016-04-10,3,Pokrajac,Blachowicz,Blachowicz,Unanimous,Cartlidge,28,29,Collett,28,29,Sutherland,28,29,-1,-1,-1
2016-04-10,3,Stanciu,Moroz,Moroz,Unanimous,Cacic,27,30,Grüner,27,30,Hughes,27,30,-3,-3,-3
2016-04-10,3,Dalby,Cummings,Cummings,Unanimous,Cartlidge,27,30,Harasim,27,30,Sutherland,27,30,-3,-3,-3
2016-04-10,3,Martins,Whiteford,Martins,Split,Cacic,29,28,Cartlidge,28,29,Grüner,30,27,1,-1,3
2016-04-10,3,Di Chirico,Velickovic,Velickovic,Unanimous,Cartlidge,28,29,Collett,28,29,Sutherland,27,30,-1,-1,-3
2016-04-02,5,Starks,Branch,Branch,Unanimous,Kamijo,44,49,Rosales,44,49,Trowbridge,44,49,-5,-5,-5
2016-04-02,5,Fitch,Zeferino,Fitch,Unanimous,Byrd,50,45,Morse Jarman,50,45,Weeks,50,45,5,5,5
2016-04-02,3,Magalhães,Heun,Magalhães,Unanimous,Rosales,29,28,Silbert,29,28,Trowbridge,29,28,1,1,1
2016-04-02,3,Azaitar,Davis Jr.,Azaitar,Unanimous,Byrd,29,28,Kamijo,29,28,Weeks,29,28,1,1,1
2016-04-02,3,Williams,Harris,Harris,Unanimous,Byrd,28,29,Rosales,28,29,Weeks,27,30,-1,-1,-3
2016-04-02,3,Bunnell,Roman,Bunnell,Split,Byrd,28,29,Rosales,29,28,Silbert,30,27,-1,1,3
2016-03-20,3,Ham,Rawlings,Rawlings,Unanimous,Dimitriou,27,30,Foley,27,30,Shen,28,29,-3,-3,-1
2016-03-20,3,Nakai,Smith,Smith,Unanimous,Field,28,29,Hickmott,28,29,Shen,27,30,-1,-1,-3
2016-03-20,3,Andrade,Walsh,Andrade,Unanimous,Hickmott,29,28,Keech,29,28,Sutherland,29,28,1,1,1
2016-03-20,3,Laprise,Pearson,Pearson,Split,Foley,28,29,Papaioannou,27,30,Shen,30,28,-1,-3,2
2016-03-20,3,Patrick,Brown,Patrick,Unanimous,Dimitriou,30,26,Field,30,27,Keech,30,27,4,3,3
2016-03-12,3,Hayes,Copeland,Copeland,Unanimous,Garcia,27,30,Hilsabeck,27,30,Van Tine,27,30,-3,-3,-3
2016-03-12,3,Hocum,Cavan,Hocum,Split,Garcia,28,29,Hilsabeck,29,28,Van Tine,29,28,-1,1,1
2016-03-12,3,Vogel,Heinisch,Heinisch,Unanimous,Garcia,26,30,Hilsabeck,27,29,Van Tine,26,30,-4,-2,-4
2016-03-12,3,Huber,Wimer,Huber,Unanimous,Garcia,30,27,Hilsabeck,30,27,Van Tine,30,27,3,3,3
2016-03-11,5,Maia,Porto,Maia,Unanimous,Byrd,48,47,Griffin,48,47,Weeks,49,46,1,1,3
2016-03-11,3,Modafferi,Bennett,Modafferi,Split,Morse Jarman,28,29,Rosales,29,28,Trowbridge,29,28,-1,1,1
2016-03-11,3,Frey,Tiburcio,Frey,Unanimous,Byrd,30,27,Griffin,29,28,Kamijo,30,27,3,1,3
2016-03-11,3,Greenway,Click,Greenway,Unanimous,Byrd,29,28,Morse Jarman,30,26,Weeks,29,28,1,4,1
2016-03-05,3,Latifi,Villante,Latifi,Unanimous,Cleary,30,27,D'Amato,30,27,Weeks,30,27,3,3,3
2016-03-05,3,Lawlor,Anderson,Anderson,Unanimous,Byrd,27,30,Lee,27,30,Rosales,28,29,-3,-3,-1
2016-03-05,3,Nunes,Shevchenko,Nunes,Unanimous,Griffin,29,27,Kamijo,29,28,Trowbridge,29,27,2,1,2
2016-03-05,3,Skelly,Elkins,Elkins,Unanimous,Byrd,26,30,D'Amato,27,29,Lee,27,30,-4,-2,-3
2016-03-05,3,Miller,Sanchez,Sanchez,Unanimous,Griffin,28,29,Trowbridge,28,29,Weeks,28,29,-1,-1,-1
2016-03-05,3,Sowinski,Silva da Conceicao,Sowinski,Unanimous,Cartlidge,29,28,Pawlega,29,28,Wojciechowski,29,28,1,1,1
2016-03-05,3,Saidov,Enomoto,Saidov,Unanimous,Lethaby,29,28,Pawlega,29,28,Wojciechowski,29,28,1,1,1
2016-03-05,3,Mackowiak,Bajor,Bajor,Unanimous,Cartlidge,28,29,Choinski,28,29,Lethaby,28,29,-1,-1,-1
2016-03-04,3,Gonzalez,Smith,Gonzalez,Split,Mathisen,29,28,Sutherland,29,28,Turnage,28,29,1,1,-1
2016-03-04,3,Yamauchi,Jenkins,Jenkins,Unanimous,Mathisen,27,29,Montalvo,28,29,Sutherland,27,30,-2,-1,-3
2016-03-04,3,Taimanglo,Kakai,Taimanglo,Unanimous,Mathisen,29,28,Sutherland,29,28,Turnage,29,28,1,1,1
2016-03-04,3,Carroll,Gracie,Gracie,Unanimous,Mathisen,26,30,Montalvo,27,30,Turnage,27,30,-4,-3,-3
2016-03-04,3,Turcios,Garcia,Turcios,Split,Mathisen,30,27,Montalvo,30,27,Turnage,28,29,3,3,-1
2016-03-04,3,Rencountre,Patterson,Patterson,Split,Montalvo,29,28,Sutherland,28,29,Turnage,28,29,1,-1,-1
2016-02-27,5,Silva,Bisping,Bisping,Unanimous,Cartlidge,47,48,Mullen,47,48,Roberts,47,48,-1,-1,-1
2016-02-27,3,Mousasi,Leites,Mousasi,Unanimous,Collett,30,27,Lavery,29,28,Motylewski,30,27,3,1,3
2016-02-27,3,Breese,Nakamura,Breese,Unanimous,Hughes,30,27,Roberts,30,27,Sutherland,29,28,3,3,1
2016-02-27,3,Pickett,Rivera,Pickett,Split,Cartlidge,29,28,Motylewski,28,29,Sutherland,29,28,1,-1,1
2016-02-27,3,Amirkhani,Wilkinson,Amirkhani,Unanimous,Collett,29,28,Lavery,30,27,Mullen,29,28,1,3,1
2016-02-27,3,Vera,Grant,Grant,Unanimous,Cartlidge,26,30,Hughes,26,30,Motylewski,26,30,-4,-4,-4
2016-02-27,3,Meza,Allen,Allen,Unanimous,Cartlidge,27,30,Hughes,27,30,Roberts,27,30,-3,-3,-3
2016-02-27,3,Jotko,Scott,Jotko,Unanimous,Collett,29,28,Lavery,30,27,Mullen,29,28,1,3,1
2016-02-27,3,Khabilov,Parke,Khabilov,Unanimous,Hughes,29,28,Roberts,29,28,Sutherland,29,28,1,1,1
2016-02-27,3,Omielanczuk,Danho,Omielanczuk,Majority,Cartlidge,29,29,Motylewski,29,28,Sutherland,29,28,0,1,1
2016-02-26,3,Queiroz,Kongo,Kongo,Split,Champion,29,28,Miller-Pence,27,30,Smith,28,29,1,-3,-1
2016-02-26,3,Reyno,Willis,Willis,Unanimous,Champion,27,30,Miller-Pence,28,29,Smith,27,30,-3,-1,-3
2016-02-26,3,Ovchynnikova,Ruth,Ruth,Unanimous,Champion,27,30,Danforth,28,29,Miller-Pence,28,29,-3,-1,-1
2016-02-26,3,Marquez,Harris,Harris,Unanimous,Danforth,27,30,Miller-Pence,27,30,Smith,28,29,-3,-3,-1
2016-02-26,3,Clark,Carlis,Clark,Unanimous,Champion,29,28,Danforth,29,28,Smith,29,28,1,1,1
2016-02-21,3,Kawajiri,Bermudez,Bermudez,Unanimous,Adkins,28,29,Colón,28,29,Kruszka,28,29,-1,-1,-1
2016-02-21,3,Campbell,Krause,Krause,Unanimous,Colón,28,29,Lapcevic,28,29,Rogers,28,29,-1,-1,-1
2016-02-21,3,Augusto Leleco,Smith,Smith,Unanimous,Colón,28,29,Kruszka,28,29,Rogers,28,29,-1,-1,-1
2016-02-21,3,Coy,Webb,Coy,Unanimous,Kruszka,29,28,Long,29,28,Urso,29,28,1,1,1
2016-02-21,3,Evans-Smith,Reneau,Evans-Smith,Split,Adkins,30,27,Lapcevic,29,28,Rogers,28,29,3,1,-1
2016-02-21,3,Abdurakhimov,Hamilton,Abdurakhimov,Unanimous,Kruszka,29,28,Long,29,28,Rogers,30,27,1,1,3
2016-02-20,3,Smith,Saunders,Saunders,Unanimous,Crail,28,29,Denkin,28,29,Landless,27,30,-1,-1,-3
2016-02-20,3,Paredes,Morales,Morales,Unanimous,Crail,28,29,Denkin,27,30,Lebell,28,29,-1,-3,-1
2016-02-20,3,Gutierrez,Valiev,Gutierrez,Split,Crail,29,28,Denkin,29,28,Lebell,27,30,1,1,-3
2016-02-20,3,Alvarez,Ramm,Alvarez,Unanimous,Crail,29,28,Landless,30,27,Lebell,30,27,1,3,3
2016-02-20,3,Muhammad,Kubeska,Muhammad,Majority,Crail,28,27,Landless,29,27,Lebell,28,28,1,2,0
2016-02-19,3,Vassell,Newton,Vassell,Unanimous,Ferraro,29,27,Soliz,30,26,Turnage,29,27,2,4,2
2016-02-19,3,Pineda,Sanchez,Sanchez,Split,Bell,27,29,Ferraro,29,28,Soliz,28,29,-2,1,-1
2016-02-19,3,Yanez,Hollis,Yanez,Unanimous,Bell,29,28,Ferraro,29,28,Reed,29,28,1,1,1
2016-02-19,3,Wren,Torres,Wren,Unanimous,Bell,30,27,Ferraro,30,27,Soliz,30,27,3,3,3
2016-02-06,3,Nelson,Rosholt,Nelson,Unanimous,Cleary,30,27,Kamijo,29,28,Lee,30,27,3,1,3
2016-02-06,3,Feijao,Saint Preux,Saint Preux,Unanimous,D'Amato,27,30,Trowbridge,28,29,Weeks,27,30,-3,-1,-3
2016-02-06,3,Makovsky,Benavidez,Benavidez,Unanimous,Byrd,28,29,Cleary,28,29,Lee,27,30,-1,-1,-3
2016-02-06,3,Burkman,Noons,Burkman,Unanimous,Byrd,30,27,Rosales,30,27,Trowbridge,30,27,3,3,3
2016-02-06,3,Scoggins,Borg,Scoggins,Unanimous,Byrd,30,26,Cleary,30,27,Rosales,30,27,4,3,3
2016-02-06,3,Lobov,White,White,Unanimous,Mullen,27,30,Trowbridge,27,30,Weeks,27,30,-3,-3,-3
2016-01-30,3,Alcântara,Rivera,Rivera,Unanimous,Agustin,28,29,Almeida,28,29,Cleary,28,29,-1,-1,-1
2016-01-30,3,Saffiedine,Ellenberger,Saffiedine,Unanimous,Agustin,29,28,Cleary,29,28,Tirelli,29,28,1,1,1
2016-01-30,3,Ferreira,Aubin-Mercier,Ferreira,Unanimous,Colón,29,28,Holland,29,28,Urso,30,27,1,1,3
2016-01-30,3,Reis,Ortiz,Reis,Unanimous,Colón,30,27,Tirelli,30,27,Urso,30,27,3,3,3
2016-01-30,3,Fullen,Caceres,Caceres,Unanimous,Almeida,27,30,Holland,27,30,Urso,27,30,-3,-3,-3
2016-01-30,3,Brown,Dwyer,Brown,Unanimous,Cleary,29,28,Colón,29,28,Tirelli,29,28,1,1,1
2016-01-30,3,Jackson,Makashvili,draw,Majority,Agustin,28,28,Almeida,28,28,Holland,29,27,0,0,2
2016-01-29,3,Perez,Cancino,Perez,Split,Belardo,29,28,Bray,29,28,Mccarthy,28,29,1,1,-1
2016-01-29,3,San Diego,Ruiz,San Diego,Unanimous,Lawley,29,28,Mcknight,29,28,Rosales,29,28,1,1,1
2016-01-29,3,Smitley,Arciniega,Smitley,Unanimous,Belardo,30,27,Bray,30,27,Mccarthy,30,27,3,3,3
2016-01-23,3,Fodor,Firmino,Firmino,Unanimous,Haynes,28,29,Mullen,28,29,Simmons,28,29,-1,-1,-1
2016-01-23,3,Foxworth,Willis,Willis,Unanimous,Haynes,27,30,Mullen,27,30,Simmons,27,30,-3,-3,-3
2016-01-23,3,Hartley,Johnson,Johnson,Split,Haynes,28,29,Mullen,28,29,Simmons,29,28,-1,-1,1
2016-01-17,5,Dillashaw,Cruz,Cruz,Split,D'Amato,49,46,Ginsberg,47,48,Weeks,46,49,3,-1,-3
2016-01-17,3,Alvarez,Pettis,Alvarez,Split,Crosby,29,28,Miner,29,28,Shea,28,29,1,1,-1
2016-01-17,3,Trinaldo,Pearson,Trinaldo,Unanimous,D'Amato,30,27,Ginsberg,29,28,Weeks,30,27,3,1,3
2016-01-17,3,Bochniak,Rosa,Rosa,Unanimous,Mena,27,30,Shea,28,29,Weeks,28,29,-3,-1,-1
2016-01-17,3,Barroso,Mutapcic,Barroso,Unanimous,D'Amato,29,28,Ginsberg,30,27,Lee,30,27,1,3,3
2016-01-16,3,Canuto,Schneider,Schneider,Split,Bell,28,29,Crail,29,28,Zacharatos,28,29,-1,1,-1
2016-01-02,5,Lawler,Condit,Lawler,Split,Cleary,48,47,Lee,48,47,Weeks,47,48,1,1,-1
2016-01-02,3,Larkin,Tumenov,Tumenov,Split,Byrd,29,28,Cleary,28,29,Kamijo,28,29,1,-1,-1
2016-01-02,3,Morono,Noke,Morono,Split,D'Amato,29,28,Lee,29,28,Morse Jarman,27,30,1,1,-3
2016-01-02,3,Nunes,Kish,Kish,Unanimous,Kamijo,27,30,Rosales,28,29,Trowbridge,27,30,-3,-1,-3
2016-01-02,3,Dober,Holtzman,Dober,Unanimous,Byrd,29,28,D'Amato,29,28,Weeks,29,28,1,1,1
2016-01-02,3,Poirier,Duffy,Poirier,Unanimous,Kamijo,30,27,Morse Jarman,30,26,Trowbridge,30,27,3,4,3
2016-01-02,3,Tanaka,Soto,Tanaka,Split,Byrd,28,29,Lee,29,28,Weeks,29,28,-1,1,1
2015-12-19,3,Johnson,Diaz,Diaz,Unanimous,Cleary,28,29,Lee,28,29,Silbert,28,29,-1,-1,-1
2015-12-19,3,Markos,Kowalkiewicz,Kowalkiewicz,Unanimous,Balas,27,30,Cleary,28,29,Silbert,28,29,-3,-1,-1
2015-12-19,3,Shevchenko,Kaufman,Shevchenko,Split,Balas,29,28,Gomez,29,28,Luxenberg,28,29,1,1,-1
2015-12-19,3,Castillo,Lentz,Lentz,Split,Cleary,28,29,Lee,27,30,Luxenberg,29,28,-1,-3,1
2015-12-19,3,Usman,Edwards,Usman,Unanimous,Balas,29,28,D'Amato,29,28,Luxenberg,30,27,1,1,3
2015-12-18,5,Palmer,Almeida,Almeida,Unanimous,D'Amato,47,48,Hagen,47,48,Rosales,47,48,-1,-1,-1
2015-12-18,3,Herron-Webb,Dugulubgov,Dugulubgov,Unanimous,Byrd,27,30,Kamijo,27,30,Morse Jarman,27,30,-3,-3,-3
2015-12-18,3,Hill,Magomedov,Hill,Split,Byrd,28,29,Hagen,30,27,Kamijo,30,27,-1,3,3
2015-12-18,3,Williams,Heun,Heun,Split,D'Amato,28,29,Morse Jarman,29,28,Rosales,28,29,-1,1,-1
2015-12-18,3,Davis Jr.,Nurmagomedov,Nurmagomedov,Unanimous,Kamijo,27,30,Urso,28,29,Winter,27,30,-3,-1,-3
2015-12-18,3,Jordan,Nunez,Nunez,Unanimous,Byrd,27,30,Hagen,27,30,Morse Jarman,26,30,-3,-3,-4
2015-12-18,3,Chikadze,Guardado,Guardado,Unanimous,Byrd,27,30,D'Amato,27,30,Urso,28,29,-3,-3,-1
2015-12-18,3,Dawodu,Magomedov,draw,Majority,Kamijo,28,28,Rosales,28,29,Urso,28,28,0,-1,0
2015-12-12,3,Souza,Romero,Romero,Split,Griffin,29,28,Trowbridge,27,29,Weeks,28,29,1,-2,-1
2015-12-12,3,Nelson,Maia,Maia,Unanimous,Byrd,26,30,Cleary,25,30,D'Amato,25,30,-4,-5,-5
2015-12-12,3,Holloway,Stephens,Holloway,Unanimous,Kamijo,29,28,Lee,30,27,Trowbridge,30,27,1,3,3
2015-12-12,3,Faber,Saenz,Faber,Unanimous,Griffin,29,28,Rosales,29,28,Weeks,30,27,1,1,3
2015-12-12,3,Jones-Lybarger,Torres,Torres,Unanimous,D'Amato,27,30,Lee,27,30,Trowbridge,27,30,-3,-3,-3
2015-12-12,3,Medeiros,Makdessi,Medeiros,Split,D'Amato,28,29,Griffin,29,28,Rosales,29,28,-1,1,1
2015-12-12,3,McGee,Alexandre Jr.,McGee,Unanimous,Cleary,29,28,Kamijo,29,28,Weeks,30,27,1,1,3
2015-12-11,3,Lobov,Hall,Hall,Unanimous,Cleary,26,30,D'Amato,27,30,Kamijo,26,30,-4,-3,-4
2015-12-11,3,Dunham,Lauzon,Dunham,Unanimous,Cleary,30,27,D'Amato,30,26,Trowbridge,30,26,3,4,4
2015-12-11,3,Kawajiri,Knight,Kawajiri,Unanimous,Kamijo,30,27,Lee,30,27,Rosales,30,27,3,3,3
2015-12-11,3,Erosa,Wrzosek,Erosa,Split,Cleary,28,29,D'Amato,29,28,Hagen,29,28,-1,1,1
2015-12-11,3,Erokhin,Gonzaga,Gonzaga,Unanimous,Hagen,28,30,Silbert,27,30,Trowbridge,27,30,-2,-3,-3
2015-12-11,3,Pierce,LaFlare,LaFlare,Unanimous,Griffin,27,30,Kamijo,28,29,Rosales,28,29,-3,-1,-1
2015-12-11,3,Lloveras,Gruetzemacher,Gruetzemacher,Unanimous,Griffin,28,29,Hagen,28,29,Silbert,28,29,-1,-1,-1
2015-12-10,3,Theodorou,Santos,Santos,Unanimous,Hagen,27,29,Kamijo,28,29,Trowbridge,27,29,-2,-1,-2
2015-12-10,3,Nover,Tukhugov,Tukhugov,Split,Byrd,29,28,Hagen,27,30,Silbert,27,30,1,-3,-3
2015-12-04,3,Weichel,Karakhanyan,Weichel,Unanimous,Rosales,30,27,Saucedo,30,27,Vierra,30,27,3,3,3
2015-12-04,3,Anderson,Freire,Anderson,Split,Miner,29,28,Saucedo,29,28,Vierra,28,29,1,1,-1
2015-12-04,3,Wasi,Hester,Hester,Unanimous,Rosales,27,30,Saucedo,24,30,Vierra,25,30,-3,-6,-5
2015-11-28,5,Masvidal,Henderson,Henderson,Split,Craig,48,47,Foley,47,48,Keech,46,49,1,-1,-3
2015-11-28,3,Mina,Akiyama,Mina,Split,Craig,28,29,Field,29,28,Foley,29,28,-1,1,1
2015-11-28,3,Nam,de la Torre,de la Torre,Split,Field,28,29,Foley,29,28,Keech,28,29,-1,1,-1
2015-11-28,3,Kuntz,Bang,Bang,Split,Craig,29,28,Harriman,28,29,Keech,28,29,1,-1,-1
2015-11-28,3,Ham,Casey,Ham,Unanimous,Craig,29,28,Field,29,28,Foley,29,28,1,1,1
2015-11-28,3,Ning,Beltran,Beltran,Split,Craig,29,28,Field,28,29,Harriman,28,29,1,-1,-1
2015-11-28,3,Koike,Sowinski,Sowinski,Unanimous,Cartlidge,27,30,Lethaby,27,30,Pawlega,27,30,-3,-3,-3
2015-11-28,3,Chlewicki,Kurczewski,Chlewicki,Unanimous,Cartlidge,30,27,Pawlega,29,28,Stanczuk,29,28,3,1,1
2015-11-28,3,Zawada,Szymuszowski,Szymuszowski,Split,Pawlega,28,29,Stanczuk,29,28,Wojciechowski,27,30,-1,1,-3
2015-11-28,3,Wawrzyniak,Bienkowski,Bienkowski,Majority,Cartlidge,27,29,Lethaby,26,29,Porebski,28,28,-2,-3,0
2015-11-28,12,Klitschko,Fury,Fury,Unanimous,Caiz Sr.,112,115,Cerdan,111,116,Ramos,112,115,-3,-5,-3
2015-11-21,12,Cotto,Álvarez,Álvarez,Unanimous,Clements,110,118,Mckaie,111,117,Moretti,109,119,-8,-6,-10
2015-11-21,5,Gastelum,Magny,Magny,Split,Colón,47,48,Rosales,47,48,Urso,48,47,-1,-1,1
2015-11-21,3,Sanchez,Lamas,Lamas,Unanimous,Rosales,27,30,Silbert,27,30,Urso,27,30,-3,-3,-3
2015-11-21,3,Cejudo,Formiga,Cejudo,Split,Cleary,30,27,Colón,30,27,Silbert,28,29,3,3,-1
2015-11-21,3,Marin,Montaño,Montaño,Split,Colón,29,28,Silbert,28,29,Urso,28,29,1,-1,-1
2015-11-21,3,Barzola,Gutierrez,Barzola,Unanimous,Cleary,30,27,Rosales,30,26,Silbert,30,27,3,4,3
2015-11-21,3,Escudero,Silva,Silva,Unanimous,Colón,28,29,Rosales,28,29,Silbert,28,29,-1,-1,-1
2015-11-21,3,Lapilus,Perez,Perez,Unanimous,Cleary,28,29,Colón,28,29,Urso,28,29,-1,-1,-1
2015-11-21,3,Urbina,Fabinski,Fabinski,Unanimous,Cleary,27,30,Rosales,27,30,Silbert,28,29,-3,-3,-1
2015-11-21,3,Prazeres,Lazaro,Prazeres,Split,Rosales,29,28,Silbert,28,29,Urso,29,28,1,-1,1
2015-11-20,3,Thomison,Jones,Jones,Unanimous,Hatley,28,29,Sutherland,28,29,Turnage,28,29,-1,-1,-1
2015-11-20,3,Jenkins,Parsons,Jenkins,Split,Hatley,30,27,Mathisen,28,29,Turnage,29,28,3,-1,1
2015-11-20,3,Rainey,Njokuani,Njokuani,Unanimous,Mathisen,28,29,Sutherland,28,29,Turnage,28,29,-1,-1,-1
2015-11-20,3,Budd,Samad,Budd,Unanimous,Mathisen,30,26,Sutherland,30,27,Turnage,30,27,4,3,3
2015-11-20,3,Neer,Santos,Santos,Unanimous,Mathisen,28,29,Sutherland,28,29,Turnage,28,29,-1,-1,-1
2015-11-20,3,Blencowe,Holloway,Blencowe,Split,Mathisen,29,28,Sutherland,28,29,Turnage,29,28,1,-1,1
2015-11-20,3,Burley,Mustapaev,Mustapaev,Unanimous,Flores,27,30,Frank,27,30,Gabauer,27,30,-3,-3,-3
2015-11-15,5,Jedrzejczyk,Létourneau,Jedrzejczyk,Unanimous,Dimitriou,49,46,Field,50,45,Shen,49,46,3,5,3
2015-11-15,3,Hall,Whittaker,Whittaker,Unanimous,Collett,27,30,Foley,28,29,Shen,27,30,-3,-1,-3
2015-11-15,3,Struve,Rosholt,Rosholt,Unanimous,Dimitriou,28,29,Field,28,29,Keech,28,29,-1,-1,-1
2015-11-15,3,Vaculik,Martinez,Martinez,Unanimous,Collett,27,30,Field,27,30,Foley,27,30,-3,-3,-3
2015-11-15,3,Montgomery,Kelly,Kelly,Unanimous,Collett,28,29,Dimitriou,28,29,Keech,28,29,-1,-1,-1
2015-11-15,3,Walsh,Kennedy,Walsh,Unanimous,Field,30,27,Foley,30,27,Shen,29,28,3,3,1
2015-11-07,3,Burns,Magomedov,Magomedov,Unanimous,Bravo,27,30,Lee,27,30,Torriero,27,30,-3,-3,-3
2015-11-07,3,Maldonado,Anderson,Anderson,Unanimous,Borges,27,30,Lee,27,30,Vieira,27,30,-3,-3,-3
2015-11-07,3,Cabral,Case,Case,Unanimous,Borges,28,29,Cleary,28,29,Vieira,28,29,-1,-1,-1
2015-11-07,3,Andrade,Umalatov,Andrade,Unanimous,Bravo,30,27,Lee,30,27,Torriero,29,28,3,3,1
2015-11-07,3,Munhoz,Rivera,Rivera,Split,Borges,28,29,Cleary,29,28,Vieira,28,29,-1,1,-1
2015-11-06,5,Freire,Straus,Straus,Unanimous,Brown,46,49,Francis,47,48,Swanberg,47,48,-3,-1,-1
2015-11-06,5,Brooks,Held,Brooks,Unanimous,Buesking,50,45,Francis,49,46,Veale,49,46,5,3,3
2015-11-06,3,Lawrence,Sanchez,Sanchez,Split,Brown,28,29,Buesking,28,29,Veale,29,28,-1,-1,1
2015-11-06,3,Huddleston,Sakai,Sakai,Unanimous,Brown,28,29,Buesking,28,29,Veale,28,29,-1,-1,-1
2015-11-06,3,Crotty,Gross,Gross,Unanimous,Francis,27,30,Swanberg,27,30,Veale,27,30,-3,-3,-3
2015-10-31,3,Winner,Krakowski,Krakowski,Unanimous,Cartlidge,28,29,Motylewski,27,30,Wojciechowski,28,29,-1,-3,-1
2015-10-24,3,Parke,Madadi,Parke,Unanimous,Grüner,30,27,Haigh,30,27,Sutherland,30,27,3,3,3
2015-10-24,3,Ray,Lebout,Ray,Unanimous,Collett,29,28,Grüner,30,27,Hughes,30,27,1,3,3
2015-10-24,3,Daly,Almeida,Daly,Unanimous,Grüner,30,27,Hughes,29,27,Sutherland,29,28,3,2,1
2015-10-24,3,Askham,Jotko,Jotko,Split,Haigh,28,29,Sutherland,29,28,Weir,28,29,-1,1,-1
2015-10-24,3,Whiteford,Elkins,Elkins,Unanimous,Grüner,27,30,Sutherland,27,30,Weir,27,30,-3,-3,-3
2015-10-24,3,Till,Dalby,draw,Majority,Collett,29,28,Roberts,28,28,Weir,28,28,1,0,0
2015-10-23,3,Haley,Zichelle,Haley,Unanimous,Anderson,29,28,Macdonald,30,27,Peabody,29,28,1,3,1
2015-10-23,3,Hepburn,Watford,Watford,Unanimous,Miner,27,30,Peabody,27,30,Sanidad,27,30,-3,-3,-3
2015-10-17,3,Fitch,Okami,Fitch,Unanimous,Colón,29,28,Ginsberg,30,27,Tirelli,30,27,1,3,3
2015-10-17,3,Newell,Marcellino,Newell,Unanimous,Colón,29,28,Ginsberg,29,28,Sanidad,29,28,1,1,1
2015-10-17,5,Frelow,Bibulatov,Bibulatov,Unanimous,Colón,45,50,Feldman,45,50,Sanidad,45,50,-5,-5,-5
2015-10-17,3,Smith,da Silva,Smith,Unanimous,Colón,30,26,Ginsberg,30,26,Sanidad,30,26,4,4,4
2015-10-17,3,King,Walsh,Walsh,Unanimous,Feldman,27,30,Ginsberg,27,30,Tirelli,27,30,-3,-3,-3
2015-10-17,3,Harris,Torrey,Harris,Split,Colón,28,29,Feldman,29,28,Sanidad,29,28,-1,1,1
2015-10-17,3,Almeida,Boyington,Boyington,Split,Colón,29,28,Ginsberg,28,29,Tirelli,28,29,1,-1,-1
2015-10-03,5,Cormier,Gustafsson,Cormier,Split,Cleary,47,48,D'Amato,48,47,Hatley,49,46,-1,1,3
2015-10-03,3,Bader,Evans,Bader,Unanimous,Collazo,30,27,Ferraro,30,27,Patlán,30,27,3,3,3
2015-10-03,3,Magomedov,Jordan,Magomedov,Unanimous,Cleary,30,27,D'Amato,30,27,Reed,29,28,3,3,1
2015-10-03,3,Bagautinov,Benavidez,Benavidez,Unanimous,Cleary,28,29,D'Amato,27,30,Soliz,27,30,-1,-3,-3
2015-10-03,3,Pena,Eye,Pena,Unanimous,Ferraro,29,27,Patlán,29,27,Reed,29,27,2,2,2
2015-10-03,3,Rodriguez,Hooker,Rodriguez,Unanimous,Cleary,30,27,Ferraro,30,27,Reed,30,26,3,3,4
2015-10-03,3,Cariaso,Pettis,Pettis,Unanimous,Cleary,28,29,D'Amato,27,29,Patlán,27,29,-1,-2,-2
2015-09-27,5,Nelson,Barnett,Barnett,Unanimous,Craig,47,48,Field,45,50,Keech,47,48,-1,-5,-1
2015-09-27,3,Horiguchi,Camus,Horiguchi,Unanimous,Craig,30,27,Field,30,27,Shen,30,27,3,3,3
2015-09-27,3,Roop,Mizugaki,Mizugaki,Unanimous,Kamijo,28,29,Keech,28,29,Shen,28,29,-1,-1,-1
2015-09-27,3,Kasuya,Hein,Hein,Unanimous,Field,28,29,Shen,28,29,Shen,27,30,-1,-1,-3
2015-09-27,3,Kotani,Johnson,Johnson,Unanimous,Booth,28,29,Craig,28,29,Shen,27,30,-1,-1,-3
2015-09-27,3,Ishihara,Hirota,draw,Split,Booth,28,29,Keech,29,28,Shen,29,29,-1,1,0
2015-09-25,3,Warren,Davis,Warren,Unanimous,Bell,30,27,Maldonado,30,27,Wincapaw,30,27,3,3,3
2015-09-25,3,Corrales,Sanchez,Sanchez,Split,Bell,27,30,Maldonado,30,27,Wincapaw,28,29,-3,3,-1
2015-09-25,3,Ramirez,Elizondo,Ramirez,Unanimous,Beltran,29,28,Maldonado,29,28,Wincapaw,29,28,1,1,1
2015-09-25,3,Macapa,Santos,Macapa,Split,Bell,29,28,Maldonado,29,28,Wess,28,29,1,1,-1
2015-09-19,3,Pica,Alonso,Pica,Unanimous,Mccarthy,29,27,Saucedo,29,27,Vierra,29,27,2,2,2
2015-09-19,3,Neal,Carrasco,Carrasco,Unanimous,Cleary,27,30,Mccarthy,28,29,Vierra,28,29,-3,-1,-1
2015-09-19,3,Diagne,Malott,draw,Majority,Bray,28,28,Cleary,28,28,Vierra,29,28,0,0,1
2015-09-18,3,Jones,Valiev,Valiev,Unanimous,Flores,27,30,Gabauer,28,29,O'connell,27,30,-3,-1,-3
2015-09-18,3,Mladenov,Starks,Starks,Unanimous,Flores,27,30,Gabauer,27,30,O'connell,28,29,-3,-3,-1
2015-09-18,3,Frincu,Davis Jr.,Frincu,Split,Gabauer,28,29,O'connell,30,27,Prendergast,29,28,-1,3,1
2015-09-18,3,Nuzzo,Ponce,Nuzzo,Unanimous,Flores,30,27,O'connell,30,27,Prendergast,29,28,3,3,1
2015-09-12,3,Kankaanpää,Bennett,Bennett,Unanimous,Gueary,28,29,Marquez,28,29,Miller,28,29,-1,-1,-1
2015-09-12,3,Jacobson,Moyle,Jacobson,Unanimous,Danforth,30,27,Gueary,29,28,Marquez,30,27,3,1,3
2015-09-12,3,Frey,McCarthy,Frey,Unanimous,Gueary,30,27,Marquez,29,28,Miller,29,28,3,1,1
2015-09-12,12,Martinez,Salido,draw,Split,Clements,113,115,Feldman,114,114,Morse Jarman,115,113,-2,0,2
2015-09-05,5,Johnson,Dodson,Johnson,Unanimous,Cleary,50,45,Rosales,49,46,Weeks,49,46,5,3,3
2015-09-05,3,Arlovski,Mir,Arlovski,Unanimous,Byrd,30,27,D'Amato,29,28,Lee,29,28,3,1,1
2015-09-05,3,Anderson,Blachowicz,Anderson,Unanimous,D'Amato,30,25,Lee,29,26,Morse Jarman,30,25,5,3,5
2015-09-05,3,Pearson,Felder,Pearson,Split,Byrd,30,27,Cleary,29,28,Urso,28,29,3,1,-1
2015-09-05,3,Collard,Trator,Trator,Split,Byrd,28,29,Cleary,28,29,Weeks,29,28,-1,-1,1
2015-09-05,3,Silva,Malegarie,Silva,Split,Byrd,30,27,Rosales,30,27,Urso,28,29,3,3,-1
2015-08-28,3,Cisneros,Miglioli,Cisneros,Unanimous,Bell,29,28,Crail,30,27,Herzog,29,28,1,3,1
2015-08-28,3,Sloan,Bondole,Bondole,Unanimous,Bell,27,30,Crail,28,29,Denkin,27,30,-3,-1,-3
2015-08-28,3,Millender,Ciacco,Millender,Unanimous,Bell,30,27,Denkin,30,27,Herzog,30,27,3,3,3
2015-08-28,3,Guillard,Girtz,Girtz,Split,Allen,29,28,Bell,27,29,Mccarthy,27,29,1,-2,-2
2015-08-28,3,Freire,Awad,Freire,Unanimous,Allen,30,27,Bell,30,27,Mccarthy,30,27,3,3,3
2015-08-28,3,Burns,Wren,Wren,Unanimous,Bell,26,30,Crail,27,30,Mccarthy,26,30,-4,-3,-4
2015-08-28,3,Macfarlane,Rios,Macfarlane,Split,Bell,29,28,Crail,29,28,Denkin,28,29,1,1,-1
2015-08-28,3,Anderson,Primus,Primus,Split,Bell,28,29,Crail,27,29,Denkin,29,28,-1,-2,1
2015-08-23,3,Magny,Silva,Magny,Split,D'Amato,30,27,Jackson,28,29,Therien,29,28,3,-1,1
2015-08-23,3,Aubin-Mercier,Sims,Aubin-Mercier,Unanimous,D'Amato,29,28,Rodgers,30,27,Therien,30,27,1,3,3
2015-08-23,3,Moroz,Létourneau,Létourneau,Unanimous,Dornan,28,29,Jackson,28,29,Therien,27,30,-1,-1,-3
2015-08-23,3,Beal,Kelades,Kelades,Split,D'Amato,28,29,Jackson,28,29,Therien,30,27,-1,-1,3
2015-08-23,3,Campbell,Silverio,Campbell,Unanimous,Dornan,29,28,Rodgers,29,28,Therien,29,28,1,1,1
2015-08-08,3,Johnson,Dariush,Dariush,Split,Bertrand,28,29,Crosby,28,29,D'Amato,29,28,-1,-1,1
2015-08-08,3,Johnson,Rosholt,Rosholt,Unanimous,Bertrand,28,29,Cleary,28,29,Lee,28,29,-1,-1,-1
2015-08-08,3,Borg,Herrera,Borg,Unanimous,Cleary,30,27,Crosby,30,27,D'Amato,30,27,3,3,3
2015-08-08,3,Camozzi,Watson,Camozzi,Unanimous,Bertrand,29,27,Cleary,29,27,D'Amato,30,26,2,2,4
2015-08-08,3,Saenz,Kakai,Saenz,Split,Bertrand,30,27,Cleary,28,29,Lee,30,27,3,-1,3
2015-08-01,3,Starks,Kyle,Starks,Unanimous,Kamijo,29,28,Rosales,29,28,Trowbridge,30,27,1,1,3
2015-08-01,3,Nurmagomedov,Moreno,Nurmagomedov,Unanimous,Byrd,30,27,Griffin,30,26,Morse Jarman,30,26,3,4,4
2015-08-01,3,Nogueira,Rua,Rua,Unanimous,Bertrand,28,29,Bravo,28,29,D'Amato,28,29,-1,-1,-1
2015-08-01,3,Vieira,Lopes,Vieira,Unanimous,Bertrand,29,28,Pontes,30,27,Weeks,30,27,1,3,3
2015-08-01,3,Nogueira,Struve,Struve,Unanimous,Bertrand,27,30,D'Amato,27,30,Pontes,27,30,-3,-3,-3
2015-08-01,3,Aguilar,Gadelha,Gadelha,Unanimous,Bertrand,27,30,Bravo,27,30,Terrell,27,30,-3,-3,-3
2015-08-01,3,Alcântara,Issa,Alcântara,Unanimous,Bertrand,29,28,Pontes,29,27,Weeks,29,28,1,2,1
2015-08-01,3,Viana,Cannetti,Cannetti,Unanimous,Bertrand,28,29,D'Amato,28,29,Weeks,28,29,-1,-1,-1
2015-07-25,3,Tate,Eye,Tate,Unanimous,D'Amato,30,27,Puccillo,30,27,Winter,30,27,3,3,3
2015-07-25,3,Barboza,Felder,Barboza,Unanimous,Caldwell,29,28,D'Amato,29,28,Goodman,29,28,1,1,1
2015-07-25,3,Castillo,Miller,Miller,Split,D'Amato,29,28,Puccillo,28,29,Winter,27,30,1,-1,-3
2015-07-25,3,Robertson,Saunders,Saunders,Split,Caldwell,28,29,D'Amato,29,28,Winter,28,29,-1,1,-1
2015-07-25,3,Caraway,Wineland,Caraway,Unanimous,Caldwell,29,28,Goodman,30,27,Puccillo,29,28,1,3,1
2015-07-25,3,Holbrook,Nijem,Holbrook,Split,Caldwell,29,28,Puccillo,28,29,Winter,29,28,1,-1,1
2015-07-25,3,Phillips,Duke,Phillips,Unanimous,Caldwell,29,28,Puccillo,29,28,Sabaitis,29,28,1,1,1
2015-07-18,5,Leites,Bisping,Bisping,Split,Collett,46,49,Hughes,47,48,Sutherland,48,47,-3,-1,1
2015-07-18,3,Pearson,Dunham,Dunham,Unanimous,Haigh,27,30,Harriman,27,30,Roberts,28,29,-3,-3,-1
2015-07-18,3,Casey,Wood,Wood,Unanimous,Collett,28,29,Haigh,27,30,Roberts,27,30,-1,-3,-3
2015-07-18,3,Pawlak,Edwards,Edwards,Unanimous,Harriman,27,30,Roberts,27,30,Weir,27,30,-3,-3,-3
2015-07-18,3,Lee,Holohan,Holohan,Unanimous,Haigh,27,30,Sutherland,27,30,Weir,27,30,-3,-3,-3
2015-07-18,3,Packalén,Lebout,Lebout,Unanimous,Haigh,28,29,Hughes,27,30,Sutherland,28,29,-1,-3,-1
2015-07-17,5,Koreshkov,Lima,Koreshkov,Unanimous,Colón,50,45,Miner,48,47,Tirelli,50,45,5,1,5
2015-07-17,3,Cardarelli,Giovanella,Cardarelli,Unanimous,Colón,30,27,Miner,29,28,Sanidad,29,28,3,1,1
2015-07-15,3,Thomson,Ferguson,Ferguson,Unanimous,Beltran,27,30,Cleary,27,30,Vierra,26,30,-3,-3,-4
2015-07-15,3,Holm,Reneau,Holm,Unanimous,Beltran,29,28,Smith,30,27,Vierra,30,26,1,3,4
2015-07-15,3,Gamburyan,Jorgensen,Gamburyan,Unanimous,Bell,30,27,Cleary,29,28,Vierra,30,27,3,1,3
2015-07-15,3,Dwyer,Jouban,Jouban,Unanimous,Bell,27,29,Beltran,27,29,Vierra,27,29,-2,-2,-2
2015-07-15,3,Sicilia,Meza,Sicilia,Unanimous,Bell,29,28,Cleary,30,27,Vierra,29,28,1,3,1
2015-07-15,3,Moras,Andrade,Andrade,Unanimous,Beltran,26,30,Cleary,26,30,Smith,27,30,-4,-4,-3
2015-07-15,3,Yahya,Kanehara,Yahya,Split,Bell,29,28,Beltran,29,28,Smith,28,29,1,1,-1
2015-07-15,3,Araujo,Strickland,Strickland,Unanimous,Bell,26,30,Smith,26,30,Vierra,27,30,-4,-4,-3
2015-07-15,3,Casey,Alcântara,Casey,Unanimous,Beltran,30,27,Cleary,30,27,Smith,30,27,3,3,3
2015-07-12,3,Graves,Luque,Graves,Unanimous,D'Amato,29,28,Kamijo,29,28,Morse Jarman,29,28,1,1,1
2015-07-12,3,Sanders,Doane,Sanders,Unanimous,Cleary,30,27,D'Amato,29,28,Morse Jarman,29,28,3,1,1
2015-07-12,3,Miller,Smith,Smith,Unanimous,Kamijo,25,30,Lee,25,30,Rosales,26,30,-5,-5,-4
2015-07-12,3,Waters,Sullivan,Sullivan,Unanimous,Cleary,27,29,Morse Jarman,25,30,Trowbridge,28,29,-2,-5,-1
2015-07-11,3,Garcia,Swick,Garcia,Unanimous,Cleary,30,27,Griffin,29,28,Lee,30,27,3,1,3
2015-07-11,3,Pendred,Howard,Howard,Split,Byrd,28,29,Rosales,28,29,Weeks,29,28,-1,-1,1
2015-07-11,3,Briones,Garbrandt,Garbrandt,Unanimous,D'Amato,27,30,Kamijo,27,30,Morse Jarman,27,30,-3,-3,-3
2015-07-11,3,Smolka,Seery,Smolka,Unanimous,Cleary,30,27,Griffin,30,27,Lee,30,27,3,3,3
2015-07-11,3,Pfister,Cedeno,Pfister,Unanimous,Kamijo,29,28,Morse Jarman,29,28,Weeks,29,28,1,1,1
2015-07-09,5,Hamasaki,Tiburcio,Hamasaki,Split,Byrd,48,47,Griffin,47,48,Trowbridge,49,46,1,-1,3
2015-07-09,3,Clark,Kianzad,Kianzad,Unanimous,Kamijo,27,30,Morse Jarman,27,30,Weeks,27,30,-3,-3,-3
2015-07-09,3,Moyle,Montenegro,Moyle,Split,Kamijo,29,28,Morse Jarman,29,28,Weeks,28,29,1,1,-1
2015-06-27,3,Makashvili,Dias,Dias,Split,Bertrand,28,29,Gomez,28,29,Rodriguez,29,28,-1,-1,1
2015-06-27,3,Merritt,Oliveira,Oliveira,Unanimous,Bertrand,27,30,Lee,27,30,Rodriguez,27,30,-3,-3,-3
2015-06-27,3,Gonzalez,Silva,Silva,Unanimous,Bertrand,27,30,Gomez,28,29,Lee,28,29,-3,-1,-1
2015-06-27,3,Martinez,Kakai,Kakai,Unanimous,Bertrand,27,30,Gomez,27,30,Rodriguez,27,30,-3,-3,-3
2015-06-26,3,Volkov,Kongo,Kongo,Unanimous,D'Amato,27,30,Miller-Pence,27,30,Smith,27,30,-3,-3,-3
2015-06-26,3,Sanchez,Curran,Curran,Unanimous,D'Amato,27,30,Miller-Pence,27,30,Smith,27,30,-3,-3,-3
2015-06-26,3,Fissori,Razafiarison,Fissori,Unanimous,Champion,29,28,Miller-Pence,29,28,Smith,29,28,1,1,1
2015-06-26,3,Cooper,Villaseca,Cooper,Split,Champion,29,28,D'Amato,28,29,Smith,29,28,1,-1,1
2015-06-20,3,Siver,Kawajiri,Kawajiri,Unanimous,Cartlidge,28,29,Hughes,28,29,Motylewski,28,29,-1,-1,-1
2015-06-20,3,Sajewski,Hein,Hein,Unanimous,Hughes,27,30,Motylewski,27,30,Sutherland,27,30,-3,-3,-3
2015-06-20,3,Lahat,Backstrom,Lahat,Majority,Collett,28,28,Sutherland,29,28,Vogt,29,28,0,1,1
2015-06-19,3,Heatherly,Gross,Heatherly,Unanimous,Brown,29,28,Buesking,29,28,Veale,29,28,1,1,1
2015-06-19,3,Irvin,Pulley,Pulley,Split,Brown,27,30,Francis,28,29,Harper,29,28,-3,-1,1
2015-06-13,3,Alvarez,Melendez,Alvarez,Split,Cleary,29,28,D'Amato,29,28,Lee,28,29,1,1,-1
2015-06-13,3,Rodriguez,Rosa,Rodriguez,Split,Cleary,29,28,Lee,29,28,Trowbridge,28,29,1,1,-1
2015-06-13,3,Hill,Torres,Torres,Unanimous,Bertrand,27,30,D'Amato,28,29,Rosales,27,30,-3,-1,-3
2015-06-13,3,Camus,Cejudo,Cejudo,Unanimous,D'Amato,27,30,Rosales,27,30,Urso,28,29,-3,-3,-1
2015-06-13,3,Trevino,Case,Case,Unanimous,D'Amato,27,30,Lee,27,30,Rosales,27,30,-3,-3,-3
2015-06-13,3,Montano,Pendred,Pendred,Unanimous,Bertrand,28,29,Cleary,28,29,Urso,28,29,-1,-1,-1
2015-06-13,3,Collard,Benitez,Benitez,Unanimous,Lee,27,30,Rosales,27,30,Trowbridge,27,30,-3,-3,-3
2015-06-06,3,Giagos,Wade,Wade,Unanimous,Barahona,27,30,Bass,28,29,Silbert,28,29,-3,-1,-1
2015-06-06,3,Collier,Abreu,Collier,Split,Gaudet,29,28,Scheuermann,29,28,Urso,28,29,1,1,-1
2015-06-05,3,Drummond,Hill,Hill,Split,Collins,28,29,Donahue,28,29,Mccallister,29,28,-1,-1,1
2015-05-30,3,Barroso,Jimmo,Barroso,Unanimous,Bravo,30,27,Lee,30,27,Terrell,29,28,3,3,1
2015-05-30,3,Parke,Trinaldo,Trinaldo,Split,Frank,28,29,Lee,29,28,Winter,28,29,-1,1,-1
2015-05-30,3,Reis,Formiga,Formiga,Unanimous,Lee,28,29,Terrell,28,29,Winter,28,29,-1,-1,-1
2015-05-30,3,Zaleski dos Santos,Dalby,Dalby,Split,Bravo,28,29,Frank,28,29,Winter,29,28,-1,-1,1
2015-05-30,3,Lima,Almeida,Lima,Unanimous,Frank,30,27,Lee,30,25,Winter,30,27,3,5,3
2015-05-23,3,Benavidez,Moraga,Benavidez,Unanimous,Kamijo,30,27,Rosales,30,27,Weeks,30,27,3,3,3
2015-05-23,3,Dodson,Makovsky,Dodson,Unanimous,Cleary,29,28,D'Amato,29,28,Morse Jarman,29,28,1,1,1
2015-05-23,3,Natal,Hall,Natal,Split,D'Amato,29,28,Kamijo,29,28,Morse Jarman,28,29,1,1,-1
2015-05-23,3,Pyle,Covington,Covington,Unanimous,Byrd,27,30,Kamijo,28,29,Rosales,27,30,-3,-1,-3
2015-05-23,3,Sampo,Scoggins,Scoggins,Unanimous,Cleary,27,30,Morse Jarman,27,30,Weeks,27,30,-3,-3,-3
2015-05-23,3,Graham,Bedorf,Bedorf,Unanimous,Cartlidge,27,30,Lethaby,27,30,Pawlega,27,30,-3,-3,-3
2015-05-23,3,Vegh,Reljic,Reljic,Split,Pawlega,28,29,Porebski,29,28,Wojciechowski,28,29,-1,1,-1
2015-05-23,3,Jewtuszko,Szymuszowski,Szymuszowski,Unanimous,Cartlidge,28,29,Lethaby,28,29,Porebski,28,29,-1,-1,-1
2015-05-16,5,Faber,Edgar,Edgar,Unanimous,Booth,45,50,Foley,45,50,Papaioannou,45,50,-5,-5,-5
2015-05-16,3,Mousasi,Philippou,Mousasi,Unanimous,Craig,30,27,Field,30,27,Shen,30,27,3,3,3
2015-05-16,3,Munoz,Barnatt,Munoz,Unanimous,Booth,30,27,Field,30,27,Foley,29,28,3,3,1
2015-05-16,3,Nover,Nam,Nover,Split,Craig,29,28,Foley,28,29,Papaioannou,29,28,1,-1,1
2015-05-16,3,Makashvili,Eddiva,Makashvili,Split,Field,29,28,Papaioannou,28,29,Shen,30,27,1,-1,3
2015-05-16,3,Zhang,Johnson,Johnson,Unanimous,Craig,27,30,Foley,28,29,Papaioannou,28,29,-3,-1,-1
2015-05-16,3,Ticman,Zhikui,Zhikui,Split,Field,28,29,Foley,29,28,Shen,28,29,-1,1,-1
2015-05-15,3,Bunch,Perez,Bunch,Unanimous,Bray,29,28,Cleary,29,28,Griffin,29,28,1,1,1
2015-05-15,3,Radach,Reiter,Reiter,Unanimous,Denkin,27,30,Griffin,27,30,Mccarthy,28,29,-3,-3,-1
2015-05-15,3,Dantas,Richman,Dantas,Unanimous,Cleary,29,28,Denkin,29,28,Mccarthy,29,28,1,1,1
2015-05-15,3,Caldwell,Silva,Caldwell,Unanimous,Cleary,29,28,Denkin,29,28,Mccarthy,29,28,1,1,1
2015-05-10,3,Webb,Noke,Noke,Split,Foley,28,29,Keech,28,29,Shen,30,27,-1,-1,3
2015-05-10,3,O'Reilly,Grujic,O'Reilly,Unanimous,Foley,29,28,Hinde,29,28,Shen,29,28,1,1,1
2015-05-03,12,Pacquiao,Mayweather,Mayweather,Unanimous,Clements,112,116,Feldman,112,116,Moretti,110,118,-4,-4,-8
2015-04-25,3,Maldonado,Jackson,Jackson,Unanimous,Lefebvre,28,29,Procopio,27,30,Roussel,27,30,-1,-3,-3
2015-04-25,3,Dollaway,Bisping,Bisping,Unanimous,Bertrand,28,29,Roussel,28,29,Therien,28,29,-1,-1,-1
2015-04-25,3,Riggs,Cote,Cote,Unanimous,Bertrand,28,29,D'Amato,28,29,Therien,28,29,-1,-1,-1
2015-04-25,3,Barberena,Laprise,Laprise,Unanimous,D'Amato,28,29,Lefebvre,27,30,Procopio,28,29,-1,-3,-1
2015-04-25,3,Taleb,Clements,Taleb,Unanimous,Lefebvre,30,27,Procopio,30,27,Therien,30,27,3,3,3
2015-04-25,3,Rakoczy,Létourneau,Létourneau,Unanimous,Bertrand,28,29,D'Amato,27,30,Roussel,28,29,-1,-3,-1
2015-04-25,3,Markos,Daly,Markos,Unanimous,Lefebvre,29,28,Procopio,29,28,Therien,30,27,1,1,3
2015-04-24,3,Modafferi,Porto,Porto,Unanimous,Danforth,27,30,Gueary,27,30,Harper,27,30,-3,-3,-3
2015-04-24,3,Gomes,Canuto,Canuto,Unanimous,Danforth,28,29,Gueary,28,29,Miller,28,29,-1,-1,-1
2015-04-24,3,Morgan,Walker,Walker,Unanimous,Gueary,27,30,Harper,27,30,Miller,27,30,-3,-3,-3
2015-04-24,3,Owen,Jacobson,Jacobson,Unanimous,Danforth,27,30,Gueary,27,30,Harper,27,30,-3,-3,-3
2015-04-24,3,Riordon,Sinn,Sinn,Unanimous,Danforth,27,30,Harper,28,29,Miller,28,29,-3,-1,-1
2015-04-18,3,Herrig,VanZant,VanZant,Unanimous,Agustin,26,30,Cleary,27,29,Tabora,26,30,-4,-2,-4
2015-04-18,3,Miller,Dariush,Dariush,Unanimous,Cleary,28,29,Colón,28,29,Tirelli,28,29,-1,-1,-1
2015-04-18,3,Gordon,Dempsey,Dempsey,Split,Agustin,28,29,Depasquale Jr.,29,28,Urso,28,29,-1,1,-1
2015-04-11,3,Blachowicz,Manuwa,Manuwa,Unanimous,Cartlidge,27,30,Harriman,27,30,Sutherland,28,29,-3,-3,-1
2015-04-11,3,Pawlak,Westcott,Pawlak,Unanimous,Collett,29,28,Grüner,29,28,Sutherland,29,28,1,1,1
2015-04-11,3,Fabinski,McLellan,Fabinski,Unanimous,Grüner,30,27,Haigh,30,27,Harriman,30,27,3,3,3
2015-04-11,3,Moraes,Lebout,Moraes,Unanimous,Cartlidge,29,28,Collett,29,28,Hughes,29,28,1,1,1
2015-04-11,3,Meza,Stasiak,Meza,Unanimous,Collett,30,27,Haigh,29,28,Sutherland,29,28,3,1,1
2015-04-11,3,Hamilton,Omielanczuk,Hamilton,Unanimous,Cartlidge,29,27,Grüner,29,28,Harriman,29,28,2,1,1
2015-04-11,3,Lee,Lapilus,Lapilus,Unanimous,Cartlidge,27,30,Collett,27,30,Hughes,27,30,-3,-3,-3
2015-04-10,3,Newell,Condon,Newell,Unanimous,Crosby,29,28,Ginsberg,29,28,Tirelli,29,28,1,1,1
2015-04-10,3,Fodor,Walo,Walo,Unanimous,Colón,28,29,Crosby,28,29,Tirelli,28,29,-1,-1,-1
2015-04-10,3,Almeida,Foster,Almeida,Split,Colón,30,27,Crosby,28,29,Tirelli,29,28,3,-1,1
2015-04-10,5,Brooks,Jansen,Brooks,Unanimous,Bell,49,46,Rosales,49,46,Smith,49,46,3,3,3
2015-04-10,3,Carvalho,Schilling,Carvalho,Split,Bell,30,27,Rosales,29,28,Smith,28,29,3,1,-1
2015-04-10,3,Volkov,Johnson,Johnson,Split,Bell,29,28,Rosales,28,29,Smith,28,29,1,-1,-1
2015-04-10,3,Beltran,Rogers,Beltran,Majority,Ayers,29,28,Mccarthy,28,28,Rosales,29,27,1,0,2
2015-04-10,3,Awad,Sinclair,Awad,Unanimous,Bell,30,27,Denkin,30,27,Mccarthy,30,27,3,3,3
2015-04-10,3,Guerreiro,Macapa,Macapa,Split,Beltran,28,29,Rosales,28,29,Smith,29,28,-1,-1,1
2015-04-10,3,Bondole,Herrera,draw,Split,Bell,28,29,Denkin,29,27,Rosales,28,28,-1,2,0
2015-04-04,3,Masvidal,Iaquinta,Iaquinta,Split,Crosby,30,27,Tirelli,28,29,Urso,28,29,3,-1,-1
2015-04-04,3,Chiesa,Clarke,Chiesa,Unanimous,Crosby,29,26,Tirelli,29,28,Urso,29,28,3,1,1
2015-04-04,3,Guida,Peralta,Guida,Unanimous,Crosby,30,27,Howard,30,27,Tirelli,30,27,3,3,3
2015-04-04,3,Carmouche,Murphy,Carmouche,Unanimous,Bello,29,28,Tirelli,29,28,Urso,29,28,1,1,1
2015-04-04,3,Maynard,Yakovlev,Yakovlev,Unanimous,Crosby,27,30,Howard,28,29,Tirelli,27,30,-3,-1,-3
2015-04-04,3,Jones,Stallings,Stallings,Unanimous,Bello,28,29,Tirelli,27,30,Urso,28,29,-1,-3,-1
2015-03-28,3,Spicuzza,Madrid,Spicuzza,Split,Burch,28,29,Frank,30,27,O'connell,30,27,-1,3,3
2015-03-28,3,Madrid,Villalobos,Villalobos,Unanimous,Burch,27,30,Flores,27,30,Gabauer,27,30,-3,-3,-3
2015-03-27,3,Davis,Tokoro,Davis,Split,Armstrong,28,29,Mathisen,29,28,Sutherland,29,28,-1,1,1
2015-03-27,3,Carmont,Viana,Carmont,Unanimous,Armstrong,29,28,Sutherland,29,28,Turnage,29,28,1,1,1
2015-03-27,3,Villalobos,Sanchez,Sanchez,Unanimous,Armstrong,27,30,Sutherland,28,29,Turnage,28,29,-3,-1,-1
2015-03-27,3,Holden,Roman,Holden,Unanimous,Armstrong,30,27,Mathisen,30,27,Turnage,30,27,3,3,3
2015-03-27,3,Ewing,Nail,Ewing,Unanimous,Armstrong,30,27,Mathisen,30,27,Turnage,29,28,3,3,1
2015-03-21,5,Maia,LaFlare,Maia,Unanimous,Borges,48,46,Bravo,48,46,Colón,48,46,2,2,2
2015-03-21,3,Trinaldo,Arreola,Trinaldo,Unanimous,Borges,30,27,Moura,30,27,Tirelli,30,27,3,3,3
2015-03-21,3,Mafra,Carrizosa,Mafra,Unanimous,Borges,30,27,Bravo,30,26,Moura,30,27,3,4,3
2015-03-14,5,Pettis,dos Anjos,dos Anjos,Unanimous,Cleary,45,50,D'Amato,45,50,Mathisen,45,50,-5,-5,-5
2015-03-14,3,Brown,Hendricks,Hendricks,Unanimous,Cleary,27,30,D'Amato,27,30,Montalvo,27,30,-3,-3,-3
2015-03-14,3,Nelson,Overeem,Overeem,Unanimous,Armstrong,27,30,Cleary,27,30,D'Amato,27,30,-3,-3,-3
2015-03-14,3,Cejudo,Cariaso,Cejudo,Unanimous,Armstrong,30,27,Cleary,30,27,D'Amato,30,27,3,3,3
2015-02-28,3,Holm,Pennington,Holm,Split,Cleary,28,29,Mccarthy,30,27,Vierra,29,28,-1,3,1
2015-02-28,3,Krause,Lazaro,Lazaro,Split,Bell,29,28,Rosales,28,29,Vierra,28,29,1,-1,-1
2015-02-28,3,Torres,Fullen,Fullen,Split,Mccarthy,28,29,Rosales,28,29,Vierra,29,28,-1,-1,1
2015-02-27,3,Inoue,Grasso,Grasso,Unanimous,Cleary,28,29,Denkin,26,30,Mccarthy,28,29,-1,-4,-1
2015-02-27,3,Rueda Center,Bennett,Bennett,Unanimous,Cleary,27,30,Denkin,28,29,Mccarthy,28,29,-3,-1,-1
2015-02-27,3,Montenegro,Van Buren,Montenegro,Unanimous,Cleary,30,27,Denkin,29,28,Mccarthy,29,28,3,1,1
2015-02-26,5,McGeary,Newton,McGeary,Unanimous,Colón,48,46,Tirelli,48,47,Urso,48,47,2,1,1
2015-02-26,3,Kongo,Lawal,Lawal,Split,Peabody,28,29,Tirelli,27,30,Urso,29,28,-1,-3,1
2015-02-26,3,Santos,Daley,Daley,Unanimous,Colón,28,29,Tirelli,27,29,Urso,28,29,-1,-2,-1
2015-02-26,3,Tugman,Maldonado,Tugman,Unanimous,Peabody,30,27,Tirelli,30,27,Urso,30,26,3,3,4
2015-02-22,3,Johnson,Barboza,Johnson,Unanimous,Borges,30,27,Bravo,29,28,Collett,30,27,3,1,3
2015-02-22,3,Martins,Khabilov,Martins,Split,Borges,29,28,Bravo,29,28,Rosales,28,29,1,1,-1
2015-02-22,3,Saenz,Alcântara,Saenz,Unanimous,Borges,29,28,Collett,30,27,Pontes,30,27,1,3,3
2015-02-22,3,Ponzinibbio,Strickland,Ponzinibbio,Unanimous,Bravo,30,27,Collett,30,27,Rosales,30,27,3,3,3
2015-02-22,3,Gibson,Silva de Andrade,Silva de Andrade,Unanimous,Borges,28,29,Collett,27,30,Rosales,28,29,-1,-3,-1
2015-02-22,3,Shockley,Jorge,Jorge,Unanimous,Bravo,28,29,Collett,28,29,Pontes,28,29,-1,-1,-1
2015-02-20,3,Bahari,Mankowski,Mankowski,Unanimous,Cartlidge,28,29,Lethaby,27,30,Pawlega,28,29,-1,-3,-1
2015-02-20,3,Moks,Saidov,Saidov,Unanimous,Cartlidge,27,30,Lethaby,27,30,Wojciechowski,27,30,-3,-3,-3
2015-02-20,3,Faria,Kowalkiewicz,Kowalkiewicz,Split,Cartlidge,29,28,Lethaby,28,29,Pawlega,28,29,1,-1,-1
2015-02-20,3,Wlodarek,Bajor,Wlodarek,Unanimous,Cartlidge,30,27,Pawlega,30,27,Wojciechowski,29,28,3,3,1
2015-02-20,3,Gniadek,Zawadzki,draw,Split,Cartlidge,29,28,Pawlega,28,30,Wojciechowski,29,29,1,-2,0
2015-02-14,3,Miller,Holloway,Holloway,Unanimous,D'Amato,28,29,Trowbridge,27,30,Van Tine,28,29,-1,-3,-1
2015-02-14,3,Kelly,Walsh,Kelly,Unanimous,Ramirez,29,28,Trowbridge,29,28,Weeks,30,27,1,1,3
2015-02-14,3,Prazeres,Lee,Lee,Unanimous,Hilsabeck,27,30,Ramirez,28,29,Weeks,27,30,-3,-1,-3
2015-02-14,3,de Lima,Escudero,Escudero,Unanimous,Hilsabeck,27,30,Trowbridge,27,30,Van Tine,27,30,-3,-3,-3
2015-02-14,3,Elliott,Makovsky,Makovsky,Unanimous,Hilsabeck,28,29,Ramirez,28,29,Weeks,28,29,-1,-1,-1
2015-02-13,3,Piccolotti,Ramm,Piccolotti,Unanimous,Belardo,30,27,Cleary,30,27,Rosales,30,27,3,3,3
2015-02-13,3,Curran,Weichel,Weichel,Split,Belardo,28,29,Cleary,28,29,Rosales,29,28,-1,-1,1
2015-02-13,3,Budd,Holloway,Budd,Unanimous,Belardo,30,24,Cleary,30,26,Mccoy,30,25,6,4,5
2015-02-13,3,Arciniega,Chavez,Chavez,Unanimous,Bray,28,29,Cleary,27,30,Mccoy,28,29,-1,-3,-1
2015-02-12,5,Hill,Moraes,Moraes,Unanimous,Collins,46,49,Gerke,46,49,Staszuk,46,49,-3,-3,-3
2015-01-31,5,Silva,Diaz,Silva,Unanimous,D'Amato,49,46,Rosales,50,45,Trowbridge,50,45,3,5,5
2015-01-31,3,Gastelum,Woodley,Woodley,Split,Byrd,28,29,Lee,29,28,Weeks,27,30,-1,1,-3
2015-01-31,3,Tate,McMann,Tate,Majority,Griffin,29,27,Hagen,29,28,Trowbridge,28,28,2,1,0
2015-01-31,3,Lineker,McCall,Lineker,Unanimous,Hagen,29,28,Lee,29,28,Weeks,29,28,1,1,1
2015-01-31,3,Natal,Watson,Natal,Unanimous,Byrd,30,27,D'Amato,30,27,Griffin,30,26,3,3,4
2015-01-31,3,Alcântara,Moreira,Alcântara,Split,Griffin,29,28,Kamijo,28,29,Weeks,29,28,1,-1,1
2015-01-24,3,Bader,Davis,Bader,Split,Collett,28,29,Nilsson,29,28,Roberts,29,28,-1,1,1
2015-01-24,3,Musoke,Tumenov,Tumenov,Unanimous,Collett,28,29,Grüner,28,29,Hughes,28,29,-1,-1,-1
2015-01-24,3,Redmond,Bektic,Bektic,Unanimous,Gunnarson,27,30,Hughes,25,30,Sutherland,27,30,-3,-5,-3
2015-01-24,3,Erokhin,Pesta,Pesta,Unanimous,Grüner,27,30,Roberts,28,29,Sutherland,27,30,-3,-1,-3
2015-01-24,3,Beal,Seery,Seery,Unanimous,Collett,28,29,Hughes,27,30,Nilsson,28,29,-1,-3,-1
2015-01-18,3,Cerrone,Henderson,Cerrone,Unanimous,Crosby,29,28,D'Amato,29,28,Mena,29,28,1,1,1
2015-01-18,3,Tibau,Parke,Tibau,Split,D'Amato,29,28,Lee,29,28,Rita,28,29,1,1,-1
2015-01-18,3,Pendred,Spencer,Pendred,Unanimous,Colón,30,27,Crosby,30,27,Ginsberg,29,28,3,3,1
2015-01-18,3,Wade,Zhang,Wade,Unanimous,Colón,30,26,Mena,30,26,Rita,30,26,4,4,4
2015-01-18,3,Howell,Holohan,Holohan,Unanimous,D'Amato,27,30,Ginsberg,27,30,Lee,27,30,-3,-3,-3
2015-01-18,3,Matsuda,Sanchez,Sanchez,Split,Crosby,29,28,Mena,27,30,Rita,28,29,1,-3,-1
2015-01-17,3,Kornberger,Mladenov,Mladenov,Unanimous,Griffin,28,29,Morse Jarman,27,30,Urso,27,30,-1,-3,-3
2015-01-17,3,Hansen,Morales,Hansen,Unanimous,Kamijo,30,27,Morse Jarman,30,26,Silbert,30,25,3,4,5
2015-01-17,3,Cella,Davis Jr.,Davis Jr.,Unanimous,Griffin,27,29,Silbert,27,29,Urso,27,29,-2,-2,-2
2015-01-17,3,Frelow,McCorriston,Frelow,Unanimous,Griffin,29,28,Kamijo,29,28,Silbert,29,28,1,1,1
2015-01-16,3,Alexander,Zwicker,Zwicker,Split,Bell,28,29,Griffin,30,27,Mccarthy,28,29,-1,3,-1
2015-01-16,3,Zaromskis,Gonzalez,Gonzalez,Unanimous,Bell,27,30,Beltran,27,30,Denkin,27,30,-3,-3,-3
2015-01-03,5,Jones,Cormier,Jones,Unanimous,Rosales,49,46,Urso,49,46,Weeks,49,46,3,3,3
2015-01-03,3,Cerrone,Jury,Cerrone,Unanimous,D'Amato,30,27,Lee,30,27,Trowbridge,30,27,3,3,3
2015-01-03,3,Tavares,Marquardt,Tavares,Unanimous,Byrd,30,27,Rosales,30,27,Urso,30,27,3,3,3
2015-01-03,3,Horiguchi,Gaudinot,Horiguchi,Unanimous,D'Amato,30,27,Trowbridge,29,28,Weeks,30,27,3,1,3
2015-01-03,3,Burkman,Lombard,Lombard,Unanimous,Morse Jarman,28,29,Rosales,27,30,Urso,27,30,-1,-3,-3
2015-01-03,3,Damm,Dunham,Dunham,Unanimous,Morse Jarman,27,30,Trowbridge,27,30,Weeks,27,30,-3,-3,-3
2015-01-03,3,Nilsson,Akhmedov,Akhmedov,Unanimous,Byrd,28,29,D'Amato,28,29,Lee,28,29,-1,-1,-1
2015-01-03,3,Reneau,Dufresne,Reneau,Unanimous,Morse Jarman,30,25,Rosales,30,26,Urso,30,26,5,4,4
2014-12-20,3,Cummins,Carlos Junior,Cummins,Unanimous,Amaral,30,27,Griffin,30,27,Pontes,30,27,3,3,3
2014-12-20,3,Elkins,Dias,Dias,Unanimous,Bravo,27,30,Pontes,28,29,Weeks,28,29,-3,-1,-1
2014-12-20,3,Alexandre Jr.,Means,Means,Split,Amaral,28,29,Griffin,28,29,Weeks,29,28,-1,-1,1
2014-12-13,5,dos Santos,Miocic,dos Santos,Unanimous,Cleary,48,47,Rosales,49,46,Trowbridge,49,46,1,3,3
2014-12-13,3,Diaz,dos Anjos,dos Anjos,Unanimous,D'Amato,26,30,Rosales,26,30,Trowbridge,27,30,-4,-4,-3
2014-12-13,3,Gadelha,Jedrzejczyk,Jedrzejczyk,Split,Cleary,28,29,Flores,28,29,Rosales,29,28,-1,-1,1
2014-12-13,3,Michaud,Whiteley,Michaud,Unanimous,D'Amato,29,28,O'connell,30,27,Trowbridge,29,28,1,3,1
2014-12-13,3,Cejudo,Kimura,Cejudo,Unanimous,Cleary,30,27,Flores,30,27,Rosales,30,27,3,3,3
2014-12-13,3,Moraes,Solorio,Moraes,Split,Saucedo,28,29,Thomas-Gitlin,30,27,Vierra,29,28,-1,3,1
2014-12-13,3,Hansen,Berkovic,Berkovic,Unanimous,Saucedo,28,29,Thomas-Gitlin,28,29,Vierra,28,29,-1,-1,-1
2014-12-13,3,Gonzalez,Buchholz,Gonzalez,Split,Saucedo,28,29,Thomas-Gitlin,29,28,Vierra,30,27,-1,1,3
2014-12-13,3,Waters,Sano,Waters,Unanimous,Saucedo,30,27,Thomas-Gitlin,29,28,Vierra,29,28,3,1,1
2014-12-13,3,Mitchell,Sanchez,Sanchez,Unanimous,Saucedo,27,30,Thomas-Gitlin,28,29,Vierra,28,29,-3,-1,-1
2014-12-13,3,Powell,Avila,Powell,Unanimous,Felipe,30,27,Saucedo,30,27,Vierra,30,27,3,3,3
2014-12-13,3,Espinosa,Morales,Morales,Unanimous,Saucedo,27,30,Thomas-Gitlin,27,30,Vierra,26,30,-3,-3,-4
2014-12-12,3,Stephens,Oliveira,Oliveira,Unanimous,Griffin,28,29,Rosales,28,29,Weeks,27,30,-1,-1,-3
2014-12-12,3,Markos,Penne,Penne,Split,Griffin,29,28,Kamijo,27,30,Weeks,28,29,1,-3,-1
2014-12-12,3,Rawlings,Clark,Clark,Unanimous,Byrd,28,29,Griffin,28,29,Trowbridge,28,29,-1,-1,-1
2014-12-12,3,Ham,Wood,Wood,Unanimous,D'Amato,27,30,Silbert,26,30,Weeks,27,30,-3,-4,-3
2014-12-12,3,Torres,Magana,Torres,Unanimous,Kamijo,30,27,Rosales,30,26,Trowbridge,30,27,3,4,3
2014-12-12,3,Hill,Kagan,Hill,Unanimous,D'Amato,30,26,Griffin,30,27,Kamijo,30,26,4,3,4
2014-12-06,5,Hendricks,Lawler,Lawler,Split,D'Amato,48,47,Rosales,47,48,Trowbridge,46,49,1,-1,-3
2014-12-06,3,Anderson,Jones,Anderson,Unanimous,Griffin,30,26,Kamijo,30,27,Weeks,30,27,4,3,3
2014-12-06,3,Pettis,Hobar,Pettis,Unanimous,Cleary,29,28,Griffin,30,27,Weeks,29,28,1,3,1
2014-12-06,3,Collard,White,Collard,Unanimous,D'Amato,29,28,Kamijo,29,28,Trowbridge,29,28,1,1,1
2014-12-06,3,Cooper,Khalidov,Khalidov,Unanimous,Cartlidge,28,29,Grela,27,30,Wojciechowski,28,30,-1,-3,-2
2014-12-06,3,Nastula,Pudzianowski,Pudzianowski,Unanimous,Bonkowski,28,30,Cartlidge,28,29,Wojciechowski,28,29,-2,-1,-1
2014-12-06,3,Narkun,Reljic,Reljic,Majority,Bonkowski,29,29,Preiss,28,29,Wojciechowski,28,29,0,-1,-1
2014-12-06,3,Chlewicki,Gamrot,Gamrot,Unanimous,Bonkowski,28,30,Grela,27,30,Wojciechowski,27,30,-2,-3,-3
2014-12-06,3,Bakocevic,Sowinski,Sowinski,Split,Cartlidge,28,29,Preiss,28,29,Wojciechowski,29,28,-1,-1,1
2014-12-06,3,Piskorz,Radomski,Radomski,Unanimous,Bonkowski,28,29,Cartlidge,28,29,Wojciechowski,28,29,-1,-1,-1
2014-12-06,3,Strus,Silva,draw,Majority,Bonkowski,29,29,Cartlidge,28,29,Grela,29,29,0,-1,0
2014-12-05,3,Modafferi,Lee,Modafferi,Split,Beltran,29,28,Moore,30,27,Zaragoza,28,29,1,3,-1
2014-12-05,3,Bennett,Maia,Bennett,Unanimous,Beltran,29,28,Moore,30,27,Zaragoza,29,28,1,3,1
2014-12-05,3,Morgan,Wawro,Morgan,Unanimous,Beltran,30,27,Moore,30,27,Zaragoza,29,28,3,3,1
2014-12-05,3,Ostovich,Johnson,Ostovich,Split,Beltran,29,28,Moore,28,29,Zaragoza,29,28,1,-1,1
2014-11-22,3,Green,Barboza,Barboza,Unanimous,Rosales,27,30,Schorle,27,30,Townsend,27,30,-3,-3,-3
2014-11-22,3,Camus,Pickett,Camus,Split,Rosales,29,28,Schorle,27,30,Townsend,29,28,1,-3,1
2014-11-22,3,Ortiz,Benavidez,Benavidez,Unanimous,Cardenas,27,30,Townsend,27,30,Wright,27,30,-3,-3,-3
2014-11-22,3,Wiman,Vallie-Flagg,Wiman,Unanimous,Schorle,29,28,Townsend,30,27,Wright,30,27,1,3,3
2014-11-22,3,Copeland,Magomedov,Magomedov,Unanimous,Cardenas,27,30,Rosales,27,30,Wright,28,29,-3,-3,-1
2014-11-22,3,Barnatt,Narvaez,Narvaez,Split,Rosales,28,29,Schorle,29,28,Townsend,28,29,-1,1,-1
2014-11-22,3,Hein,Vick,Vick,Unanimous,Cardenas,27,30,Townsend,28,29,Wright,28,29,-3,-1,-1
2014-11-15,5,Bahari,Dalby,Dalby,Unanimous,Cartlidge,45,50,Collett,45,50,Lethaby,45,50,-5,-5,-5
2014-11-15,5,Kianzad,Siiskonen,Kianzad,Unanimous,Cartlidge,50,45,Collett,50,45,Lethaby,49,46,5,5,3
2014-11-15,3,Rogers,Sinclair,Rogers,Unanimous,Cartlidge,30,27,Collett,30,27,Lethaby,30,27,3,3,3
2014-11-15,3,Guillard,Gaethje,Gaethje,Split,Luxenberg,28,29,Reichbach,29,28,Ross,27,30,-1,1,-3
2014-11-15,5,Aguilar,Faria,Aguilar,Unanimous,Davis,49,45,Luxenberg,49,45,Ross,49,45,4,4,4
2014-11-15,3,Reynolds,Patino,Patino,Unanimous,Davis,27,30,Reichbach,28,29,Ross,27,30,-3,-1,-3
2014-11-15,3,Gerhart,Hutchinson,Hutchinson,Unanimous,Luxenberg,28,29,Reichbach,28,29,Ross,28,29,-1,-1,-1
2014-11-15,3,Ortiz,Bonnar,Ortiz,Split,Bell,30,27,Cleary,28,29,Smith,30,27,3,-1,3
2014-11-15,3,Henderson,Santa Maria,Santa Maria,Split,Landless,28,29,Lebell,29,28,Magallanes,27,30,-1,1,-3
2014-11-15,3,Murad,Pugh,Murad,Split,Landless,29,28,Lebell,29,28,Magallanes,28,29,1,1,-1
2014-11-15,3,Rodriguez,Morales,Rodriguez,Unanimous,Bertrand,29,28,Crosby,29,28,Rosales,29,28,1,1,1
2014-11-15,3,Perez,Quinonez,Perez,Unanimous,D'Amato,29,26,Lee,28,27,Urso,29,26,3,1,3
2014-11-15,3,Beltran,Vera,Beltran,Unanimous,Bertrand,29,28,Crosby,29,28,D'Amato,29,28,1,1,1
2014-11-15,3,Perez,Vorgeas,draw,Split,Landless,28,28,Lebell,27,29,Magallanes,30,26,0,-2,4
2014-11-08,3,Alves,Jouban,Alves,Unanimous,Borges,29,28,Moura,29,28,Silbert,29,28,1,1,1
2014-11-08,3,Silva,Edwards,Silva,Split,Bravo,28,29,Cleary,29,28,Silbert,29,28,-1,1,1
2014-11-08,3,Lima,de Oliveira,Lima,Unanimous,Borges,30,27,Moura,30,27,Silbert,30,27,3,3,3
2014-11-08,3,Lima,Nunes,Lima,Unanimous,Bravo,29,28,Cleary,29,28,Moura,29,28,1,1,1
2014-11-08,3,Rivas,Rubio,Rivas,Unanimous,Borges,30,27,Cleary,30,27,Moura,30,27,3,3,3
2014-11-08,3,Almeida,Gorman,Almeida,Unanimous,Bravo,30,27,Moura,29,28,Silbert,30,27,3,1,3
2014-11-01,5,Honchak,Hashi,Honchak,Unanimous,Caldwell,50,45,Gynan,49,46,Hawxby,50,45,5,3,5
2014-11-01,3,Inoue,Kowalkiewicz,Kowalkiewicz,Split,Caldwell,28,29,Hawxby,29,28,Wilson,28,29,-1,1,-1
2014-11-01,3,Brown,McCarthy,Brown,Split,Caldwell,29,28,Gynan,28,29,Wilson,30,27,1,-1,3
2014-11-01,3,Goodwin,McGill,McGill,Unanimous,Caldwell,27,30,Gynan,28,29,Wilson,28,29,-3,-1,-1
2014-11-01,3,Rooney,Haque,Haque,Unanimous,Cartlidge,27,30,Lethaby,27,30,Sledge,27,30,-3,-3,-3
2014-11-01,3,Lasota,Caswell,Caswell,Unanimous,Cartlidge,28,29,Lethaby,28,29,Sledge,28,29,-1,-1,-1
2014-11-01,5,Enlund,Narimani,Enlund,Unanimous,Cartlidge,48,47,Lethaby,48,47,Sledge,48,47,1,1,1
2014-11-01,3,Mann,Benkaci,Mann,Unanimous,Cartlidge,30,27,Lethaby,30,27,Sledge,30,27,3,3,3
2014-11-01,3,James,Trueman,James,Unanimous,Cartlidge,30,27,Lethaby,30,27,Sledge,30,27,3,3,3
2014-11-01,3,Connor,Malone,Malone,Split,Cartlidge,28,29,Lethaby,29,28,Sledge,28,29,-1,1,-1
2014-10-25,5,Mendes,Aldo,Aldo,Unanimous,Bertrand,46,49,Borges,46,49,Bravo,46,49,-3,-3,-3
2014-10-25,3,Teixeira,Davis,Davis,Unanimous,Borges,27,30,Bravo,27,30,Colón,27,30,-3,-3,-3
2014-10-25,3,Elkins,Martins,Elkins,Split,Bertrand,30,27,Colón,30,27,Lins,27,30,3,3,-3
2014-10-25,3,Ferreira,Dariush,Dariush,Unanimous,Borges,27,30,Bravo,27,30,Lins,27,30,-3,-3,-3
2014-10-25,3,Arantes,Fili,Fili,Unanimous,Borges,28,29,Bravo,28,29,Colón,28,29,-1,-1,-1
2014-10-24,3,Rickels,Ramos,Rickels,Unanimous,Caldwell,29,28,Champion,29,28,Miller-Pence,29,28,1,1,1
2014-10-24,3,Jansen,Hawn,Jansen,Unanimous,Caldwell,30,27,Champion,30,27,Malott,29,28,3,3,1
2014-10-24,3,Dizy,Caldwell,Caldwell,Unanimous,Champion,27,30,Malott,27,30,Miller-Pence,27,30,-3,-3,-3
2014-10-24,3,Derrow,Jolly,Derrow,Unanimous,Caldwell,29,28,Champion,29,28,Malott,29,28,1,1,1
2014-10-17,3,Neer,Bradley,Bradley,Unanimous,Caldwell,27,30,Goodman,27,30,Malott,27,30,-3,-3,-3
2014-10-17,3,Santos,Terry,Santos,Unanimous,Caldwell,30,27,Goodman,30,27,Malott,30,27,3,3,3
2014-10-17,3,Lawson,Cotton,Cotton,Unanimous,Caldwell,26,30,Goodman,27,30,Huckfeldt,27,30,-4,-3,-3
2014-10-17,3,Smith,Green,Smith,Unanimous,Caldwell,29,28,Goodman,30,26,Malott,30,26,1,4,4
2014-10-17,3,Marquez,Moreno,Moreno,Unanimous,Caldwell,27,30,Goodman,27,30,Malott,27,30,-3,-3,-3
2014-10-17,3,Alexander,Zwicker,draw,Majority,Caldwell,28,28,Goodman,29,28,Malott,28,28,0,1,0
2014-10-11,3,Huete,Horodecki,Horodecki,Unanimous,Donahue,27,30,Gerke,27,30,Staszuk,27,30,-3,-3,-3
2014-10-11,3,Swanson,Alves,Alves,Unanimous,Braak,27,30,Donahue,27,30,Staszuk,27,30,-3,-3,-3
2014-10-10,3,Sampson,Sykora,Sampson,Unanimous,Armstrong,30,27,Mathisen,30,27,Sutherland,30,27,3,3,3
2014-10-10,5,Warren,Dantas,Warren,Unanimous,Hatley,48,47,Mathisen,48,47,Sutherland,48,47,1,1,1
2014-10-10,3,Page,Burrell,Page,Unanimous,Hatley,30,27,Mathisen,30,27,Sutherland,30,27,3,3,3
2014-10-10,3,Coleman,Florentino,Coleman,Unanimous,Armstrong,29,28,Hatley,29,28,Mathisen,30,27,1,1,3
2014-10-10,3,Macapa,Cleve,Macapa,Split,Armstrong,29,28,Mathisen,28,29,Sutherland,29,28,1,-1,1
2014-10-04,3,Azhiev,Henriques,Azhiev,Unanimous,Grela,30,27,Preiss,30,28,Wojciechowski,30,27,3,2,3
2014-10-04,3,Gniadek,Kowalewicz,Kowalewicz,Unanimous,Bonkowski,27,29,Preiss,28,29,Wojciechowski,28,29,-2,-1,-1
2014-10-04,3,Caraway,Assuncao,Assuncao,Unanimous,Crosby,27,30,Lee,27,30,Smith,27,30,-3,-3,-3
2014-10-04,3,Cedeno,Laprise,Laprise,Unanimous,Bridgeman,27,30,Robinson,27,30,Smith,27,30,-3,-3,-3
2014-10-04,3,Theodorou,Santos,Theodorou,Unanimous,Bridgeman,29,28,Macavoy,29,28,Robinson,29,28,1,1,1
2014-10-04,3,Taleb,Jingliang,Taleb,Split,Lee,28,29,Macavoy,29,28,Smith,30,27,-1,1,3
2014-10-04,3,Njokuani,Cruickshank,Cruickshank,Unanimous,Bridgeman,27,30,Crosby,27,30,Robinson,27,30,-3,-3,-3
2014-10-04,3,Felder,Saggo,Felder,Split,Lee,28,29,Macavoy,29,28,Smith,29,28,-1,1,1
2014-10-04,3,Kelades,Holohan,Kelades,Unanimous,Lee,29,28,Macavoy,29,28,Smith,29,28,1,1,1
2014-10-04,5,Nelson,Story,Story,Split,Bergman,48,47,Collett,46,49,Sutherland,44,50,1,-3,-6
2014-10-04,3,Cedenblad,Askham,Cedenblad,Unanimous,Cartlidge,29,28,Gunnarson,29,28,Sutherland,29,28,1,1,1
2014-10-04,3,Yakovlev,Musoke,Musoke,Unanimous,Cartlidge,27,30,Collett,27,30,Sataki,27,30,-3,-3,-3
2014-10-04,3,Rosa,Siver,Siver,Unanimous,Bergman,27,30,Cartlidge,27,30,Sutherland,27,30,-3,-3,-3
2014-10-04,3,Pendred,Umalatov,Pendred,Split,Collett,29,28,Gunnarson,29,28,Sutherland,28,29,1,1,-1
2014-10-04,3,Jotko,Troeng,Jotko,Unanimous,Bergman,30,27,Cartlidge,30,26,Collett,30,27,3,4,3
2014-10-03,3,Silva,Emerson,Silva,Unanimous,Cleary,30,27,Denkin,29,28,Mccarthy,29,28,3,1,1
2014-10-03,3,Sloan,Moghaddam,Sloan,Unanimous,Davis,30,27,Denkin,30,27,Mccarthy,30,27,3,3,3
2014-10-03,3,Rios,Awad,Awad,Unanimous,Cleary,26,30,Denkin,27,30,Griffin,27,30,-4,-3,-3
2014-10-03,3,Mercurio,Baesman,Baesman,Split,Davis,28,29,Denkin,29,28,Griffin,28,29,-1,1,-1
2014-09-27,3,Cerrone,Alvarez,Cerrone,Unanimous,Griffin,29,28,Kamijo,29,28,Weeks,29,28,1,1,1
2014-09-27,3,Krause,Masvidal,Masvidal,Unanimous,Griffin,28,29,Kamijo,27,30,Trowbridge,27,30,-1,-3,-3
2014-09-27,3,Cote,Thompson,Thompson,Unanimous,Byrd,28,29,D'Amato,28,29,Weeks,27,30,-1,-1,-3
2014-09-27,3,Ebersole,Howard,Ebersole,Split,Griffin,29,28,Rosales,29,28,Urso,28,29,1,1,-1
2014-09-27,3,Lee,Tuck,Lee,Unanimous,Kamijo,30,26,Trowbridge,30,26,Weeks,30,26,4,4,4
2014-09-26,3,Held,Freire,Held,Unanimous,Burch,30,26,Gabauer,30,27,Valenzuela,29,28,4,3,1
2014-09-26,3,Meller,Jenkins,Jenkins,Unanimous,Frank,27,30,Gabauer,27,30,Valenzuela,28,29,-3,-3,-1
2014-09-26,3,Taimanglo,Parker,Taimanglo,Unanimous,Burch,30,26,Gabauer,30,27,Valenzuela,30,27,4,3,3
2014-09-20,3,Akiyama,Sadollah,Akiyama,Unanimous,Collett,30,27,Kamijo,30,27,Papaioannou,30,27,3,3,3
2014-09-20,3,Nakai,Tate,Tate,Unanimous,Kleynjans,27,30,Sutherland,27,30,Weeks,28,29,-3,-3,-1
2014-09-20,3,Walsh,Kunimoto,Kunimoto,Split,Collett,29,28,Papaioannou,28,29,Weeks,28,29,1,-1,-1
2014-09-20,3,Kanehara,Caceres,Kanehara,Unanimous,Collett,29,28,Papaioannou,29,28,Weeks,29,28,1,1,1
2014-09-20,3,Tanaka,Kang,Kang,Split,Fan,28,29,Kamijo,29,28,Papaioannou,28,29,-1,1,-1
2014-09-20,3,Hooker,Blanco,Blanco,Unanimous,Fan,28,29,Papaioannou,28,29,Weeks,28,29,-1,-1,-1
2014-09-19,3,Ruiz,James,James,Split,Belardo,28,29,Herzog,29,28,Mccoy,28,29,-1,1,-1
2014-09-19,3,Neal,Ruiz,Neal,Unanimous,Lawley,30,27,Mccoy,30,27,Mcknight,30,27,3,3,3
2014-09-19,3,Becerra,Bonilla-Bowman,Bonilla-Bowman,Split,Belardo,29,28,Mcknight,28,29,Rosales,28,29,1,-1,-1
2014-09-19,3,Juarez,Keslar,Juarez,Unanimous,Belardo,29,28,Herzog,29,28,Lawley,29,28,1,1,1
2014-09-13,3,Edwards,Desborough,Desborough,Unanimous,Cartlidge,28,29,Lethaby,27,30,Oglesby,27,30,-1,-3,-3
2014-09-13,3,Norkus,Nembhard,Nembhard,Split,Cartlidge,29,28,Lethaby,28,29,Oglesby,28,29,1,-1,-1
2014-09-13,12,Mayweather,Maidana,Mayweather,Unanimous,Cavalleri,115,112,Mckaie,116,111,Moretti,116,111,3,5,5
2014-09-13,3,Valiev,Chapman,Valiev,Unanimous,Colflesh,30,27,Monskie,30,27,Urso,30,26,3,3,4
2014-09-13,3,Perez,Marcellino,Perez,Unanimous,Kruk,30,27,Monskie,30,27,Urso,30,27,3,3,3
2014-09-13,3,Dixon,Walo,Dixon,Split,Colflesh,29,28,Kruk,29,28,Urso,28,29,1,1,-1
2014-09-13,3,Hallmann,Tibau,Tibau,Split,Borges,28,29,Lins,29,28,Puccillo,28,29,-1,1,-1
2014-09-13,3,Escudero,Santos,Santos,Unanimous,Bravo,28,29,Lins,28,29,Torriero,28,29,-1,-1,-1
2014-09-13,3,Doane,Alcântara,Alcântara,Unanimous,Lins,28,29,Puccillo,28,29,Torriero,28,29,-1,-1,-1
2014-09-13,3,Silva,Trinaldo,Trinaldo,Unanimous,Borges,28,29,Bravo,28,29,Lins,28,29,-1,-1,-1
2014-09-13,3,Thiago,Spencer,Spencer,Unanimous,Borges,27,30,Bravo,27,30,Puccillo,27,30,-3,-3,-3
2014-09-12,3,Garcia,Reiter,Reiter,Unanimous,Anderson,27,30,Caldwell,27,30,Malott,28,29,-3,-3,-1
2014-09-12,3,Davis,Rodrigues,Davis,Unanimous,Anderson,30,27,Caldwell,30,27,Malott,30,27,3,3,3
2014-09-12,3,Hadribeaj,Hamida,Hadribeaj,Split,Anderson,29,28,Caldwell,29,28,Malott,28,29,1,1,-1
2014-09-12,3,Hernandez,Vasquez,Hernandez,Unanimous,Anderson,30,27,Caldwell,29,28,Malott,29,28,3,1,1
2014-09-12,3,Henderson,Johnson,Johnson,Split,Anderson,28,29,Caldwell,28,29,Malott,29,28,-1,-1,1
2014-09-12,3,Hervey,Fischer,Fischer,Unanimous,Anderson,26,30,Caldwell,26,30,Malott,26,30,-4,-4,-4
2014-09-06,3,LaRosa,Modafferi,Modafferi,Unanimous,Gueary,28,29,Miller,27,30,Swanberg,27,30,-1,-3,-3
2014-09-06,3,Cummins,Grasso,Grasso,Unanimous,Gueary,27,30,Miller,28,29,Swanberg,28,29,-3,-1,-1
2014-09-06,3,Esquibel,Frey,Esquibel,Split,Gueary,28,29,Harper,29,28,Swanberg,29,27,-1,1,2
2014-09-06,3,Owen,Aldrich,Aldrich,Unanimous,Harper,27,30,Miller,27,30,Swanberg,26,30,-3,-3,-4
2014-09-05,5,Curran,Freire,Freire,Unanimous,Colón,46,49,Tirelli,46,49,Urso,47,48,-3,-3,-1
2014-09-05,3,Cramer,Filkins,Cramer,Unanimous,Miner,29,28,Peabody,30,27,Tirelli,30,27,1,3,3
2014-09-05,3,Bessette,Cleve,Cleve,Unanimous,Avery,28,29,Colón,28,29,Tirelli,27,30,-1,-1,-3
2014-09-05,3,Moy,Garcia,Garcia,Split,Avery,28,29,Miner,28,29,Peabody,30,27,-1,-1,3
2014-09-05,3,Maldonado,DiSciullo,DiSciullo,Unanimous,Avery,27,30,Peabody,27,30,Urso,27,30,-3,-3,-3
2014-09-05,3,Camozzi,Natal,Natal,Split,D'Amato,28,29,Sanidad,28,29,Trowbridge,29,28,-1,-1,1
2014-09-05,3,Matsuda,Beal,Beal,Unanimous,Ginsberg,28,29,Sanidad,27,30,Silbert,28,29,-1,-3,-1
2014-09-05,3,Soriano,Skelly,Skelly,Unanimous,Cleary,27,30,D'Amato,27,30,Trowbridge,27,30,-3,-3,-3
2014-08-30,3,Castillo,Ferguson,Ferguson,Split,Bell,28,29,Cleary,28,29,Landless,29,28,-1,-1,1
2014-08-30,3,Brunson,Larkin,Brunson,Unanimous,Bell,30,27,Beltran,30,27,Cleary,30,27,3,3,3
2014-08-23,3,O'Reilly,Zhang,Zhang,Unanimous,Harriman,28,29,Keech,27,30,Sutherland,27,30,-1,-3,-3
2014-08-23,3,Ning,Yang,Ning,Unanimous,Dimitriou,29,28,Keech,29,28,Sutherland,29,28,1,1,1
2014-08-23,3,Mitchell,Sai,Sai,Unanimous,Dimitriou,28,29,Harriman,28,29,Keech,28,29,-1,-1,-1
2014-08-23,3,Zhikui,Wee,Wee,Split,Hughes,28,29,Keech,30,27,Sutherland,28,29,-1,3,-1
2014-08-23,3,Phillips,Dudieva,Dudieva,Split,Dimitriou,27,30,Harriman,29,28,Hughes,28,29,-3,1,-1
2014-08-23,3,Lazaro,Vick,Vick,Unanimous,Greenwalt,28,29,Lambert,27,30,Trowbridge,28,29,-1,-3,-1
2014-08-23,3,Garcia,Magny,Magny,Unanimous,Greenwalt,27,30,Lee,27,30,Urso,28,29,-3,-3,-1
2014-08-23,3,Phillips,Hobar,Hobar,Unanimous,Cleary,28,29,Higdon,28,29,Lambert,28,29,-1,-1,-1
2014-08-23,3,Sanchez,Reis,Reis,Unanimous,Cleary,28,29,Lee,28,29,Trowbridge,28,29,-1,-1,-1
2014-08-22,3,Svensson,Hill,Svensson,Unanimous,Cartlidge,30,27,Collett,30,27,Lethaby,30,27,3,3,3
2014-08-22,3,Pirrello,Allen,Allen,Unanimous,Cartlidge,26,30,Collett,25,30,Lethaby,26,30,-4,-5,-4
2014-08-22,3,Abzakh,Hignett,Abzakh,Unanimous,Cartlidge,29,27,Collett,29,27,Lethaby,29,27,2,2,2
2014-08-16,5,Saint Preux,Bader,Bader,Unanimous,Colón,46,49,Lee,46,49,Tirelli,47,48,-3,-3,-1
2014-08-16,3,Makovsky,Formiga,Formiga,Unanimous,Colón,28,29,Ginsberg,28,29,Tirelli,28,29,-1,-1,-1
2014-08-16,3,McMann,Murphy,McMann,Split,Borssen,29,28,Lee,28,29,Mckinnon,29,28,1,-1,1
2014-08-16,3,Alvey,Watson,Watson,Unanimous,Borssen,28,29,Ginsberg,28,29,Lee,28,29,-1,-1,-1
2014-08-16,3,Ticman,Saenz,Saenz,Unanimous,Colón,27,30,Mckinnon,27,30,Tirelli,27,30,-3,-3,-3
2014-08-16,3,Moore,Clarkson,Moore,Unanimous,Cartlidge,30,25,Lethaby,30,25,Oglesby,30,27,5,5,3
2014-08-16,3,Marin,Young,Marin,Unanimous,Cartlidge,29,28,Lethaby,29,28,Oglesby,29,28,1,1,1
2014-08-16,3,Iwanowski,Queally,Queally,Unanimous,Cartlidge,28,29,Lethaby,27,30,Oglesby,27,30,-1,-3,-3
2014-08-15,3,Markes,Butterfield,Markes,Unanimous,D'Amato,29,28,Griffin,29,28,Silbert,29,28,1,1,1
2014-08-15,3,Mutapcic,Tiller,Mutapcic,Unanimous,Kamijo,29,28,Lee,30,27,Weeks,29,28,1,3,1
2014-08-15,3,Vila,Hempleman,Hempleman,Unanimous,D'Amato,28,29,Griffin,27,30,Silbert,27,30,-1,-3,-3
2014-08-15,3,Sayles,Hansen,Sayles,Unanimous,Kamijo,29,28,Lee,29,28,Weeks,29,28,1,1,1
2014-08-15,3,Lopez,Davis Jr.,Davis Jr.,Unanimous,Kamijo,28,29,Lee,28,29,Weeks,28,29,-1,-1,-1
2014-08-15,3,Acquaviva,Maltais,Acquaviva,Split,D'Amato,29,28,Griffin,28,29,Weeks,29,28,1,-1,1
2014-07-26,5,Lawler,Brown,Lawler,Unanimous,Bell,49,46,Cleary,48,47,Vierra,49,46,3,1,3
2014-07-26,3,Green,Thomson,Green,Split,Bell,28,29,Collantes,29,28,Vierra,29,28,-1,1,1
2014-07-26,3,Cruickshank,Masvidal,Masvidal,Unanimous,Cleary,28,29,Rosales,28,29,Vierra,27,29,-1,-1,-2
2014-07-26,3,Kingsbury,Cummins,Cummins,Unanimous,Bell,27,30,Collantes,25,30,Rosales,24,30,-3,-5,-6
2014-07-26,3,Perpetuo,Means,Means,Unanimous,Bell,28,29,Cleary,28,29,Vierra,28,29,-1,-1,-1
2014-07-26,3,Trator,Arreola,Trator,Unanimous,Collantes,30,27,Guingona,29,28,Rosales,30,27,3,1,3
2014-07-26,3,Stahl,Burns,Burns,Unanimous,Rosales,28,29,Saucedo,28,29,Vierra,28,29,-1,-1,-1
2014-07-26,3,Jedrzejczyk,Lima,Jedrzejczyk,Unanimous,Cleary,29,28,Guingona,30,27,Rosales,30,27,1,3,3
2014-07-26,3,Lahat,Siler,Lahat,Unanimous,Bell,29,28,Collantes,29,28,Saucedo,29,28,1,1,1
2014-07-25,3,McDonough,Koreshkov,Koreshkov,Unanimous,Bell,27,30,Denkin,27,30,Griffin,27,30,-3,-3,-3
2014-07-25,3,Gonzalez,Amoussou,Gonzalez,Unanimous,Denkin,29,28,Griffin,29,28,Mccarthy,29,28,1,1,1
2014-07-19,3,Pickett,McCall,McCall,Unanimous,Harris,27,30,Hughes,28,29,Weir,27,30,-3,-1,-3
2014-07-19,3,Seery,Harris,Seery,Unanimous,Collett,30,27,Harris,30,27,Hughes,30,27,3,3,3
2014-07-19,3,Troeng,Smith,Smith,Unanimous,Harris,28,29,Hughes,28,29,Weir,28,29,-1,-1,-1
2014-07-16,3,Healy,Tibau,Tibau,Unanimous,Colón,28,29,Tamburrino,27,30,Urso,28,29,-1,-3,-1
2014-07-16,3,Gadelha,Lähdemäki,Gadelha,Unanimous,Depasquale Jr.,30,27,Sinclair,30,27,Tabora,30,26,3,3,4
2014-07-12,12,Álvarez,Lara,Álvarez,Split,Martinez,117,111,Moretti,115,113,Roth,113,115,6,2,-2
2014-07-06,3,Scoggins,Ortiz,Ortiz,Split,Byrd,29,28,D'Amato,28,29,Lee,28,29,1,-1,-1
2014-07-06,3,Ronson,Lee,Lee,Split,Rosales,27,30,Silbert,28,29,Trowbridge,29,28,-3,-1,1
2014-07-06,3,Spohn,Walsh,Walsh,Unanimous,Byrd,28,29,Lee,28,29,Silbert,28,29,-1,-1,-1
2014-07-06,3,Moras,Dufresne,Moras,Unanimous,Cleary,29,28,Kamijo,30,27,Rosales,29,28,1,3,1
2014-07-05,3,Fitch,Hallman,Fitch,Unanimous,Reichbach,30,27,Ross,30,27,Torres,30,27,3,3,3
2014-07-05,3,Heun,Miree,Heun,Unanimous,Balas,29,28,Ross,29,28,Torres,29,28,1,1,1
2014-07-05,5,Weidman,Machida,Weidman,Unanimous,Lee,49,45,Rosales,48,47,Trowbridge,49,46,4,1,3
2014-07-05,3,Hall,Santos,Hall,Unanimous,Cleary,30,27,Silbert,29,28,Trowbridge,29,28,3,1,1
2014-07-05,3,Brimage,Doane,Doane,Split,D'Amato,29,28,Kamijo,28,29,Rosales,27,30,1,-1,-3
2014-07-05,3,Alcântara,Robertson,Robertson,Unanimous,D'Amato,26,30,Kamijo,26,30,Silbert,26,30,-4,-4,-4
2014-07-05,3,Santos,Camozzi,Santos,Split,Crosby,28,29,Lee,29,28,Trowbridge,29,28,-1,1,1
2014-07-05,3,Zachrich,Bomba,Zachrich,Unanimous,Crosby,30,27,Lee,29,28,Rosales,30,27,3,1,3
2014-06-28,5,Stephens,Swanson,Swanson,Unanimous,D'Amato,47,48,Garcia,46,49,Montalvo,46,49,-1,-3,-3
2014-06-28,3,Musoke,Gastelum,Gastelum,Unanimous,D'Amato,28,29,Garcia,28,29,Montalvo,28,29,-1,-1,-1
2014-06-28,3,Dias,Lamas,Lamas,Unanimous,Garcia,27,30,Martinez,28,29,Soliz,27,30,-3,-1,-3
2014-06-28,3,Ferreira,Craig,Ferreira,Unanimous,D'Amato,30,27,Garcia,29,28,Hatley,29,28,3,1,1
2014-06-28,3,Hester,Neto,Hester,Split,D'Amato,28,29,Martinez,29,28,Soliz,29,28,-1,1,1
2014-06-28,3,Moontasri,Ellenberger,Ellenberger,Split,Martinez,29,28,Munoz,28,29,Soliz,28,29,1,-1,-1
2014-06-28,3,Enz,Guimaraes,Guimaraes,Split,Martinez,28,29,Munoz,28,29,Soliz,30,27,-1,-1,3
2014-06-28,3,Rhodes,Whittaker,Whittaker,Unanimous,Dimitriou,27,30,Hill,27,30,Keech,27,30,-3,-3,-3
2014-06-28,3,Sangcha-an,Vaculik,Vaculik,Unanimous,Dimitriou,28,29,Keech,28,29,Papaioannou,27,30,-1,-1,-3
2014-06-28,3,O'Connell,Villante,Villante,Split,Dimitriou,28,29,Keech,29,28,Papaioannou,28,29,-1,1,-1
2014-06-21,5,Aguilar,Fujino,Aguilar,Unanimous,Byrd,50,44,Trowbridge,50,44,Urso,50,44,6,6,6
2014-06-21,3,Griffin,Firmino,Firmino,Unanimous,Crosby,28,29,Kamijo,28,29,Silbert,27,30,-1,-1,-3
2014-06-21,3,Mehmen,Huckaba,Mehmen,Unanimous,Crosby,30,26,Griffin,30,27,Silbert,30,25,4,3,5
2014-06-21,3,DeAnda,Mladenov,Mladenov,Unanimous,Crosby,27,30,Griffin,27,30,Urso,27,30,-3,-3,-3
2014-06-21,3,Spicuzza,Jaynes,Spicuzza,Unanimous,Crosby,30,27,Griffin,30,27,Kamijo,30,27,3,3,3
2014-06-14,5,Johnson,Bagautinov,Johnson,Unanimous,Bertrand,50,45,D'Amato,50,45,Therien,50,45,5,5,5
2014-06-14,3,MacDonald,Woodley,MacDonald,Unanimous,Bertrand,30,27,D'Amato,30,27,Therien,30,27,3,3,3
2014-06-14,3,Bader,Feijao,Bader,Unanimous,Bertrand,30,27,D'Amato,30,27,Weeks,30,27,3,3,3
2014-06-14,3,Schaub,Arlovski,Arlovski,Split,D'Amato,28,29,Therien,28,29,Weeks,29,28,-1,-1,1
2014-06-14,3,Phillips,Létourneau,Létourneau,Split,Cooper,28,29,D'Amato,28,29,Therien,29,28,-1,-1,1
2014-06-14,3,Jabouin,Easton,Jabouin,Unanimous,Bertrand,29,28,Weeks,29,28,Williamson,29,28,1,1,1
2014-06-14,3,Delorme,Tanaka,Tanaka,Unanimous,Bertrand,27,30,Cooper,27,30,Weeks,27,30,-3,-3,-3
2014-06-07,3,Pearson,Sanchez,Sanchez,Split,Collins,27,30,Rosales,30,27,Tellez,28,29,-3,3,-1
2014-06-07,3,Pettis,Meza,Pettis,Unanimous,Collins,29,28,D'Amato,29,28,Rosales,29,28,1,1,1
2014-06-07,3,Voelker,Benoist,Benoist,Unanimous,Collins,28,29,D'Amato,27,30,Rosales,28,29,-1,-3,-1
2014-06-07,3,Martinez,Jorgensen,Jorgensen,Unanimous,Martinez,27,30,Sanchez,28,29,Tellez,28,29,-3,-1,-1
2014-06-07,5,Warburton,Ray,Ray,Split,Cartlidge,48,47,Collett,47,48,Lethaby,45,50,1,-1,-5
2014-06-07,3,Bahari,Alloway,Bahari,Split,Cartlidge,30,27,Collett,30,27,Ryan,27,30,3,3,-3
2014-06-07,3,Bostwick,Thoresen,Bostwick,Majority,Collett,29,28,Lethaby,29,28,Ryan,28,28,1,1,0
2014-06-07,3,Carvalho,Mason,Mason,Split,Cartlidge,28,29,Lethaby,28,29,Oglesby,29,28,-1,-1,1
2014-06-07,3,Hadzovic,Delaney,Hadzovic,Unanimous,Cartlidge,29,28,Lethaby,29,28,Oglesby,29,28,1,1,1
2014-06-07,3,Wilde,Brown,Wilde,Unanimous,Cartlidge,29,28,Oglesby,29,28,Ryan,29,28,1,1,1
2014-06-07,3,Wrzosek,Allen,Wrzosek,Unanimous,Collett,30,27,Oglesby,29,28,Ryan,29,28,3,1,1
2014-06-07,3,Blackwell,Ventre,Blackwell,Unanimous,Cartlidge,30,27,Oglesby,30,27,Ryan,30,27,3,3,3
2014-06-06,3,Valavicius,Eduardo,Valavicius,Split,Mathisen,29,28,Sutherland,29,28,Turnage,28,29,1,1,-1
2014-06-06,3,Coleman,Vedepo,Vedepo,Majority,Armstrong,28,28,Mathisen,27,29,Sutherland,27,29,0,-2,-2
2014-06-06,3,Wallace,Anundson,Anundson,Unanimous,Mathisen,27,30,Sutherland,27,30,Turnage,28,29,-3,-3,-1
2014-06-06,3,Jones,McDaniel,McDaniel,Unanimous,Armstrong,27,30,Sutherland,26,30,Turnage,27,30,-3,-4,-3
2014-06-06,3,Martinez Ayme,Florentino,Florentino,Split,Armstrong,29,28,Mathisen,27,30,Sutherland,28,29,1,-3,-1
2014-05-31,3,Miranda,Carlos Junior,Carlos Junior,Unanimous,Bertrand,28,29,Lee,27,30,Lins,27,30,-1,-3,-3
2014-05-31,3,Yakovlev,Maia,Maia,Unanimous,Bertrand,27,30,Bravo,27,30,Lins,27,30,-3,-3,-3
2014-05-31,3,Jason,Peralta,Peralta,Split,Bertrand,28,29,Lee,27,30,Lins,30,27,-1,-3,3
2014-05-31,3,Magomedov,Damm,Magomedov,Unanimous,Bertrand,30,27,Lee,30,27,Lins,30,27,3,3,3
2014-05-31,3,Thiago,Umalatov,Umalatov,Unanimous,Borges,27,30,Bravo,27,30,Lee,28,29,-3,-3,-1
2014-05-31,3,Dollaway,Carmont,Dollaway,Unanimous,Cartlidge,30,27,Haigh,29,28,Sutherland,30,27,3,1,3
2014-05-31,3,Strickland,Barnatt,Strickland,Split,Collett,28,29,Haigh,30,27,Hughes,29,28,-1,3,1
2014-05-31,3,Dober,Hein,Hein,Unanimous,Haigh,28,29,Hughes,27,30,Sutherland,28,29,-1,-3,-1
2014-05-31,3,Pawlak,Sobotta,Sobotta,Unanimous,Collett,27,30,Haigh,27,30,Kobayashi,27,30,-3,-3,-3
2014-05-31,3,Ogle,Blanco,Blanco,Unanimous,Cartlidge,28,29,Collett,28,29,Sutherland,28,29,-1,-1,-1
2014-05-31,3,Magomedov,Pesta,Magomedov,Unanimous,Haigh,29,28,Hughes,29,28,Kobayashi,29,28,1,1,1
2014-05-24,3,Rivera,Mizugaki,Mizugaki,Unanimous,Lee,28,29,Silbert,27,30,Trowbridge,27,30,-1,-3,-3
2014-05-24,3,Chiesa,Trinaldo,Chiesa,Unanimous,Byrd,30,26,Silbert,30,27,Trowbridge,30,26,4,3,4
2014-05-24,3,Holdsworth,Camus,Holdsworth,Unanimous,Hagen,30,27,Silbert,30,27,Trowbridge,30,27,3,3,3
2014-05-24,3,Pichel,Njokuani,Pichel,Unanimous,Kamijo,30,27,Lee,30,27,Silbert,29,28,3,3,1
2014-05-24,3,Phillips,Sicilia,Sicilia,Unanimous,Byrd,28,29,Cleary,27,30,Trowbridge,28,29,-1,-3,-1
2014-05-24,3,Jingliang,Michaud,Jingliang,Split,Hagen,28,29,Kamijo,29,28,Weeks,30,27,-1,1,3
2014-05-17,3,Gamrot,George,Gamrot,Unanimous,Pawlega,30,27,Preiss,30,26,Rysiewski,30,27,3,4,3
2014-05-17,3,Rajewski,Chlewicki,Chlewicki,Unanimous,Bonkowski,28,29,Grela,28,29,Wojciechowski,28,30,-1,-1,-2
2014-05-17,3,Lawal,Jackson,Jackson,Unanimous,Anderson,28,29,Hinds,28,29,Leo,28,29,-1,-1,-1
2014-05-17,5,Chandler,Brooks,Brooks,Split,Anderson,46,48,Hinds,47,48,Ingle,48,47,-2,-1,1
2014-05-17,3,Richman,Yamauchi,Yamauchi,Unanimous,Cain,28,29,Hinds,28,29,Leo,28,29,-1,-1,-1
2014-05-17,3,Lyons,Underwood,Lyons,Unanimous,Anderson,29,28,Frazier,30,27,Ingle,30,27,1,3,3
2014-05-17,3,Azaitar,Strus,draw,Majority,Bonkowski,29,29,Preiss,30,28,Wojciechowski,30,30,0,2,0
2014-05-10,3,Magny,Means,Magny,Unanimous,Lee,30,27,Urso,29,28,Wise,29,28,3,1,1
2014-05-10,3,Cariaso,Smolka,Cariaso,Split,D'Amato,28,29,Lee,29,28,Urso,29,28,-1,1,1
2014-05-10,3,Natal,Herman,Herman,Unanimous,Urso,27,30,Winter,28,29,Wise,28,29,-3,-1,-1
2014-05-10,3,Horiguchi,Montague,Horiguchi,Unanimous,D'Amato,30,27,Lee,29,28,Winter,30,27,3,1,3
2014-05-10,3,Cabral,Cummings,Cummings,Unanimous,Lee,28,29,Urso,28,29,Wise,28,29,-1,-1,-1
2014-05-10,3,Lentz,Gamburyan,Lentz,Unanimous,D'Amato,30,27,Lee,30,27,Urso,30,27,3,3,3
2014-05-09,3,Alessio,Wisely,Alessio,Unanimous,Buckley,30,27,Vandermeer,30,27,Woods,30,27,3,3,3
2014-05-09,3,Zaromskis,Anderson,Zaromskis,Unanimous,Buckley,29,28,Costello,30,27,Vandermeer,30,27,1,3,3
2014-05-09,3,Horodecki,Sandro,Sandro,Unanimous,Costello,27,30,Vandermeer,28,29,Woods,27,30,-3,-1,-3
2014-05-09,3,Meisel,Bussieres,Meisel,Unanimous,Costello,29,28,Vandermeer,30,27,Woods,30,27,1,3,3
2014-05-09,3,Gordon,Kelades,Gordon,Unanimous,Buckley,29,28,Vandermeer,29,28,Woods,30,27,1,1,3
2014-05-09,3,Butler,Rossborough,draw,Majority,Buckley,28,27,Costello,28,28,Woods,28,28,1,0,0
2014-05-03,12,Maidana,Mayweather,Mayweather,Majority,Clements,111,117,Moretti,112,116,Pernick,114,114,-6,-4,0
2014-05-02,5,Warren,Silva,Warren,Unanimous,Almeida,48,47,Colón,48,47,Urso,48,47,1,1,1
2014-05-02,3,Galvão,Vasquez,Galvão,Unanimous,Almeida,30,27,Colón,30,27,Tamburrino,30,27,3,3,3
2014-05-02,3,Rivera,Adkins,Rivera,Majority,Colón,30,27,Tabora,29,29,Tamburrino,30,27,3,0,3
2014-05-02,3,Martinez,Contaldi,Martinez,Unanimous,Almeida,30,26,Tabora,30,26,Urso,30,26,4,4,4
2014-05-02,3,Fadiora,Woods,Woods,Unanimous,Almeida,28,29,Sinclair,27,30,Urso,27,30,-1,-3,-3
2014-05-02,3,Bannon,Outlaw,Outlaw,Unanimous,Colón,27,30,Tabora,27,30,Urso,27,30,-3,-3,-3
2014-05-02,3,Roddy,Aliyev,Roddy,Unanimous,Colón,29,28,Tabora,29,28,Tamburrino,29,28,1,1,1
2014-04-26,5,Teixeira,Jones,Jones,Unanimous,Cleary,45,50,Lee,45,50,Urso,45,50,-5,-5,-5
2014-04-26,3,Davis,Johnson,Johnson,Unanimous,Bertrand,27,30,Cleary,27,30,Urso,27,30,-3,-3,-3
2014-04-26,3,Gomi,Vallie-Flagg,Gomi,Unanimous,Barry,29,28,Bertrand,29,28,Colflesh,29,28,1,1,1
2014-04-26,3,Duke,Correia,Correia,Unanimous,Colflesh,28,29,Duruttya,27,30,Urso,27,30,-1,-3,-3
2014-04-19,5,Werdum,Browne,Werdum,Unanimous,Bertrand,49,46,Cleary,50,45,Lee,50,45,3,5,5
2014-04-19,3,Tate,Carmouche,Tate,Unanimous,Gomez,29,28,Lee,29,28,Vannatta,29,28,1,1,1
2014-04-19,3,Tavares,Romero,Romero,Unanimous,Bertrand,27,30,Cleary,27,30,Lee,27,30,-3,-3,-3
2014-04-19,3,Nurmagomedov,dos Anjos,Nurmagomedov,Unanimous,Lee,30,27,Vannatta,30,27,Warring,30,27,3,3,3
2014-04-19,3,Baczynski,Alves,Alves,Unanimous,Gomez,27,30,Green,27,30,Rodriguez,27,30,-3,-3,-3
2014-04-19,3,Healy,Masvidal,Masvidal,Unanimous,Bertrand,28,29,Vannatta,27,30,Warring,27,30,-1,-3,-3
2014-04-19,3,Perpetuo,Mein,Mein,Split,Bertrand,28,29,Cleary,28,29,Warring,29,28,-1,-1,1
2014-04-19,3,Ortiz,Borg,Ortiz,Split,Cleary,29,28,Gomez,28,29,Lee,29,28,1,-1,1
2014-04-19,3,Bektic,Skelly,Bektic,Majority,Green,28,28,Rodriguez,29,27,Vannatta,29,27,0,2,2
2014-04-18,3,Amoussou,Gomez,Amoussou,Split,Caldwell,28,29,Goodman,29,28,Malott,29,28,-1,1,1
2014-04-18,3,Brown,Downing,Brown,Unanimous,Caldwell,30,27,Goodman,30,27,Hawxby,29,28,3,3,1
2014-04-18,3,Wright Jr.,Burley,Burley,Unanimous,Caldwell,27,29,Goodman,28,29,Malott,27,29,-2,-1,-2
2014-04-18,3,Vallee,Mason,Mason,Unanimous,Cartlidge,27,30,Lethaby,28,29,Sledge,27,30,-3,-1,-3
2014-04-18,3,Pascu,Hermansson,Hermansson,Unanimous,Cartlidge,28,29,Lethaby,28,29,Sledge,28,29,-1,-1,-1
2014-04-18,3,Johnson,Hadbi,Hadbi,Unanimous,Cartlidge,27,30,Lethaby,27,30,Sledge,27,30,-3,-3,-3
2014-04-18,3,Aimable,Karked,Karked,Unanimous,Cartlidge,27,29,Lethaby,27,29,Sledge,27,29,-2,-2,-2
2014-04-18,3,Ravenscroft,Janeb,Janeb,Unanimous,Cartlidge,27,30,Lethaby,27,30,Sledge,27,30,-3,-3,-3
2014-04-16,5,Bisping,Kennedy,Kennedy,Unanimous,Bertrand,46,49,D'Amato,46,49,Therien,45,50,-3,-3,-5
2014-04-16,3,Cote,Noke,Cote,Unanimous,D'Amato,29,28,Lefebvre,30,27,Roussel,29,28,1,3,1
2014-04-16,3,Laprise,Aubin-Mercier,Laprise,Split,D'Amato,30,27,Philippeaux,28,29,Therien,29,28,3,-1,1
2014-04-16,3,Smith,Kaufman,Kaufman,Unanimous,Bertrand,27,30,Lefebvre,27,30,Roussel,27,30,-3,-3,-3
2014-04-16,3,Roop,Kimura,Roop,Unanimous,Bertrand,29,28,Roussel,30,27,Therien,29,28,1,3,1
2014-04-16,3,Bocek,de la Torre,Bocek,Split,Bertrand,28,29,D'Amato,29,28,Philippeaux,30,27,-1,1,3
2014-04-16,3,Taleb,Grujic,Taleb,Unanimous,Bertrand,30,27,Roussel,30,27,Therien,30,27,3,3,3
2014-04-16,3,Walsh,Indich,Walsh,Unanimous,D'Amato,30,27,Lefebvre,30,27,Therien,30,27,3,3,3
2014-04-16,3,Gorman,Gagnon,Gagnon,Unanimous,Bertrand,27,30,Philippeaux,27,30,Roussel,27,30,-3,-3,-3
2014-04-12,5,Brum,Johns,Johns,Unanimous,Lavery,46,49,Sledge,46,49,Swann,45,50,-3,-3,-5
2014-04-12,3,Saeed,Carter,Carter,Unanimous,Lavery,28,29,Sledge,27,30,Swann,28,29,-1,-3,-1
2014-04-12,3,Haque,McDonough,Haque,Unanimous,Lavery,30,27,Sledge,30,27,Swann,30,27,3,3,3
2014-04-11,3,Halsey,Pacheco,Halsey,Unanimous,Bell,30,27,Davis,30,27,Hamilton,30,27,3,3,3
2014-04-11,3,Emerson,Taimanglo,Emerson,Unanimous,Anderson,30,27,Davis,30,27,Hamilton,29,28,3,3,1
2014-04-11,3,Eduardo,Wallace,Wallace,Unanimous,Anderson,27,30,Bell,28,29,Davis,27,30,-3,-1,-3
2014-04-11,3,Guida,Kawajiri,Guida,Unanimous,Cartlidge,30,27,Roberts,30,27,Weir,30,27,3,3,3
2014-04-11,3,Howard,LaFlare,LaFlare,Unanimous,Cartlidge,28,29,Collett,28,29,Weir,28,29,-1,-1,-1
2014-04-11,3,Rosholt,Omielanczuk,Rosholt,Unanimous,Cartlidge,30,27,Collett,30,26,Hughes,30,27,3,4,3
2014-04-11,3,Alers,Omer,Alers,Split,Hughes,29,28,Roberts,29,28,Weir,28,29,1,1,-1
2014-04-04,5,Kongo,Minakov,Minakov,Unanimous,Byrd,46,48,Lee,46,48,Smith,46,48,-2,-2,-2
2014-04-04,3,Cisneros,Parlo,Parlo,Unanimous,Cleary,27,30,Smith,27,30,Trowbridge,27,30,-3,-3,-3
2014-04-04,3,Morales,Jones,Morales,Split,Cleary,28,29,Morse Jarman,29,28,Weeks,29,28,-1,1,1
2014-04-04,3,Terry,Reeves,Reeves,Split,Lee,28,29,Morse Jarman,28,29,Weeks,29,28,-1,-1,1
2014-04-04,3,Aquitania,Appelt,Aquitania,Unanimous,Byrd,29,28,Morse Jarman,29,28,Trowbridge,29,28,1,1,1
2014-04-04,3,Ramirez,Lopez,Lopez,Unanimous,Byrd,27,30,Cleary,28,29,Morse Jarman,27,30,-3,-1,-3
2014-04-04,3,Terrado,Baesman,draw,Majority,Cleary,29,28,Lee,28,28,Weeks,28,28,1,0,0
2014-03-29,5,Rettinghouse,Moraes,Moraes,Unanimous,Byrd,44,50,Kamijo,44,50,Weeks,44,50,-6,-6,-6
2014-03-29,3,Dugulubgov,Nunez,Nunez,Split,Griffin,29,28,Kamijo,28,29,Trowbridge,27,30,1,-1,-3
2014-03-29,3,Gunderson,Gruetzemacher,Gruetzemacher,Unanimous,Griffin,27,30,Smith,27,30,Trowbridge,26,30,-3,-3,-4
2014-03-29,3,Nefarios,Hansen,Hansen,Unanimous,Byrd,27,30,Morse Jarman,28,29,Weeks,27,30,-3,-1,-3
2014-03-29,3,Davis Jr.,Dace,Davis Jr.,Unanimous,Byrd,30,27,Griffin,30,27,Kamijo,30,27,3,3,3
2014-03-28,3,Berto,Martinez,Martinez,Unanimous,Dutcher,28,29,Furse,28,29,Mcmahon,28,29,-1,-1,-1
2014-03-28,3,Weichel,Bessette,Weichel,Unanimous,Andrews,29,28,Dutcher,29,28,Mcmahon,30,27,1,1,3
2014-03-28,3,Green,Martinez,Green,Unanimous,Andrews,30,27,Furse,30,27,Mcmahon,29,28,3,3,1
2014-03-28,3,Fischer,Wilcox,Wilcox,Unanimous,Andrews,28,29,Dutcher,28,29,Furse,28,29,-1,-1,-1
2014-03-28,3,Powers,Jenkins,Jenkins,Unanimous,Andrews,27,30,Dutcher,27,30,Mcmahon,27,30,-3,-3,-3
2014-03-28,3,Love,Paraisy,Paraisy,Unanimous,Cartlidge,27,30,Lethaby,27,30,Ryan,27,30,-3,-3,-3
2014-03-23,3,Villante,Maldonado,Maldonado,Unanimous,Amaral,28,29,Bertrand,27,29,Pereira,28,29,-1,-2,-1
2014-03-23,3,Taisumov,Prazeres,Prazeres,Unanimous,Bertrand,25,30,Bravo,25,30,Collett,25,30,-5,-5,-5
2014-03-23,3,Barroso,Stringer,Stringer,Split,Amaral,28,29,Bertrand,29,28,Bravo,28,29,-1,1,-1
2014-03-23,3,Santos,Parke,draw,Majority,Amaral,28,28,Collett,28,28,Pereira,29,27,0,0,2
2014-03-22,3,Bahari,Carvalho,Bahari,Unanimous,Cartlidge,29,28,Lethaby,29,28,Oglesby,29,28,1,1,1
2014-03-22,3,Olivier,Svensson,Svensson,Split,Cartlidge,29,28,Lethaby,28,29,Oglesby,28,29,1,-1,-1
2014-03-22,3,Tashkilot,Son Le,Tashkilot,Unanimous,Cartlidge,29,28,Lethaby,29,28,Oglesby,29,28,1,1,1
2014-03-22,3,Materla,Silva,Materla,Unanimous,Bonkowski,30,27,Pawlega,29,27,Wojciechowski,29,28,3,2,1
2014-03-22,3,Reljic,Celinski,Reljic,Unanimous,Pawlega,30,29,Preiss,30,29,Rysiewski,29,28,1,1,1
2014-03-22,3,Porczyk,Shaparenko,Porczyk,Unanimous,Grela,30,26,Pawlega,30,25,Rysiewski,30,25,4,5,5
2014-03-22,3,Grecicho,Kowalewicz,Grecicho,Unanimous,Bonkowski,30,28,Preiss,30,28,Rysiewski,30,28,2,2,2
2014-03-22,3,Henriques,Shamaev,Shamaev,Unanimous,Bonkowski,29,30,Grela,27,30,Wojciechowski,28,30,-1,-3,-2
2014-03-21,5,Vegh,Newton,Newton,Split,Caldwell,48,47,Champion,46,49,Miller-Pence,47,48,1,-3,-1
2014-03-21,3,Welch,Campos,Campos,Unanimous,Caldwell,27,30,Champion,27,30,Pilgrim,27,30,-3,-3,-3
2014-03-21,3,Carrillo,Giron,Giron,Unanimous,Caldwell,28,29,Miller-Pence,28,29,Pilgrim,28,29,-1,-1,-1
2014-03-21,3,Bell,Wisely,Wisely,Split,Champion,27,30,Miller-Pence,29,28,Pilgrim,28,29,-3,1,-1
2014-03-21,3,Cooper,Navarro,Cooper,Unanimous,Caldwell,29,28,Champion,30,27,Miller-Pence,29,28,1,3,1
2014-03-15,5,Hendricks,Lawler,Hendricks,Unanimous,Crosby,48,47,Gonzalez,48,47,Martinez,48,47,1,1,1
2014-03-15,3,Sanchez,Jury,Jury,Unanimous,Crosby,27,30,Gonzalez,27,30,Mathisen,28,29,-3,-3,-1
2014-03-15,3,Shields,Lombard,Lombard,Unanimous,Crosby,27,30,Gonzalez,28,29,Martinez,27,30,-3,-1,-3
2014-03-15,3,Gastelum,Story,Gastelum,Split,Crosby,28,29,Gonzalez,30,27,Martinez,29,28,-1,3,1
2014-03-15,3,Andrade,Pennington,Andrade,Split,Martinez,29,28,Mathisen,28,29,Wincapaw,29,28,1,-1,1
2014-03-15,3,Spencer,Garcia,Garcia,Split,Martinez,27,30,Mathisen,29,28,Wincapaw,28,29,-3,1,-1
2014-03-15,3,Forte,Trevino,Trevino,Unanimous,Gonzalez,28,29,Mathisen,28,29,Wincapaw,28,29,-1,-1,-1
2014-03-15,3,Campuzano,Scoggins,Scoggins,Unanimous,Crosby,27,30,Martinez,27,30,Wincapaw,27,30,-3,-3,-3
2014-03-15,3,Pineda,Whiteford,Whiteford,Unanimous,Crosby,27,30,Gonzalez,28,29,Mathisen,28,29,-3,-1,-1
2014-03-13,3,Juarez,McDonough,McDonough,Unanimous,Caldwell,28,29,Hinkel,28,29,Hunsucker,28,29,-1,-1,-1
2014-03-13,3,Coy,Bradley,Coy,Unanimous,Gaines,30,27,Hunsucker,30,27,Torriero,30,27,3,3,3
2014-03-13,3,Muhammad,Matthews,Muhammad,Unanimous,Caldwell,29,28,Hinkel,29,28,Torriero,29,28,1,1,1
2014-03-13,3,Loffer,Reardanz,Loffer,Unanimous,Gaines,30,27,Hinkel,30,27,Torriero,30,27,3,3,3
2014-03-13,3,Gomez,Guida,Gomez,Unanimous,Caldwell,30,26,Gaines,30,27,Hinkel,30,27,4,3,3
2014-03-08,3,Johnson,Guillard,Johnson,Unanimous,Cartlidge,30,27,Harris,29,28,Watts,30,27,3,1,3
2014-03-08,3,Pickett,Seery,Pickett,Unanimous,Cartlidge,29,28,Harris,30,27,Roberts,30,27,1,3,3
2014-03-08,3,Scott,Silva,Silva,Unanimous,Collett,28,29,Hughes,28,29,Roberts,28,29,-1,-1,-1
2014-03-08,3,Mitchell,Araujo,Araujo,Unanimous,Collett,27,30,Hughes,27,30,Watts,27,30,-3,-3,-3
2014-03-07,3,Ivanov,Hale,Ivanov,Unanimous,Armstrong,29,28,Mathisen,29,28,Turnage,29,28,1,1,1
2014-03-01,3,Maguire,Rogers,Rogers,Unanimous,Lethaby,28,29,Oglesby,28,29,Sledge,28,29,-1,-1,-1
2014-03-01,3,Alloway,Mason,Alloway,Unanimous,Lethaby,29,28,Oglesby,29,28,Sledge,29,28,1,1,1
2014-03-01,3,Redmond,Brown,Redmond,Unanimous,Lethaby,29,28,Oglesby,29,28,Sledge,29,28,1,1,1
2014-03-01,3,Costigan,Cabello,Costigan,Split,Lethaby,28,29,Oglesby,29,28,Sledge,29,28,-1,1,1
2014-03-01,3,Sheridan,Pimblett,Pimblett,Unanimous,Lethaby,27,30,Oglesby,27,30,Sledge,27,30,-3,-3,-3
2014-03-01,3,Iwanowski,Gunfield,Iwanowski,Split,Lethaby,29,28,Oglesby,30,27,Sledge,28,29,1,3,-1
2014-03-01,3,Sai,Zhang,Zhang,Split,Harris,30,27,Hughes,28,29,Watts,28,29,3,-1,-1
2014-03-01,3,Menjivar,Hioki,Hioki,Unanimous,Cartlidge,28,29,Collett,28,29,Harris,28,29,-1,-1,-1
2014-03-01,3,Tokudome,Nam,Nam,Split,Harris,27,29,Hughes,28,29,Watts,28,27,-2,-1,1
2014-03-01,3,Phan,Lee,Lee,Unanimous,Cartlidge,27,30,Harris,27,30,Hughes,26,30,-3,-3,-4
2014-03-01,3,Tuerxun,Eddiva,Eddiva,Unanimous,Collett,27,30,Hughes,27,30,Watts,27,30,-3,-3,-3
2014-02-28,3,Lawal,Zayats,Lawal,Unanimous,Colón,30,27,Tirelli,30,27,Urso,30,27,3,3,3
2014-02-28,3,Nunes,Bessette,Bessette,Split,Colón,28,29,Miner,29,28,Tirelli,27,30,-1,1,-3
2014-02-28,3,Green,Richman,Green,Unanimous,Colón,30,27,Miner,29,28,Urso,29,28,3,1,1
2014-02-28,3,Martinez,Yamauchi,Martinez,Unanimous,Colón,30,27,Tirelli,30,27,Urso,30,27,3,3,3
2014-02-28,3,Almeida,Fisher,Almeida,Unanimous,Colón,29,28,Randolph,29,28,Urso,29,28,1,1,1
2014-02-28,3,Calandrelli,Quinn,Quinn,Unanimous,Colón,28,29,Randolph,27,30,Urso,28,29,-1,-3,-1
2014-02-22,3,Maia,MacDonald,MacDonald,Unanimous,Griffin,28,29,Lee,28,29,Weeks,28,29,-1,-1,-1
2014-02-22,3,Eye,Davis,Davis,Split,Kamijo,28,29,Lee,29,28,Rosales,28,29,-1,1,-1
2014-02-22,3,Assuncao,Munhoz,Assuncao,Unanimous,Crosby,30,27,Griffin,30,27,Weeks,30,27,3,3,3
2014-02-22,3,Sterling,Gibson,Sterling,Unanimous,Lee,29,28,Smith,29,28,Trowbridge,29,28,1,1,1
2014-02-22,3,Sampo,Makovsky,Makovsky,Unanimous,Griffin,27,30,Kamijo,28,29,Rosales,27,30,-3,-1,-3
2014-02-22,3,Chavez,Cedeno,Chavez,Split,Kamijo,30,27,Smith,29,28,Weeks,28,29,3,1,-1
2014-02-15,3,Balde,Bostwick,Bostwick,Unanimous,Cartlidge,27,30,Collett,27,30,Lethaby,27,30,-3,-3,-3
2014-02-15,3,Suarez,Roberts,Roberts,Unanimous,Cartlidge,27,30,Collett,27,30,Lethaby,28,29,-3,-3,-1
2014-02-15,3,Howarth,Kelly,Howarth,Unanimous,Cartlidge,29,28,Collett,29,28,Lethaby,29,28,1,1,1
2014-02-15,3,Inman,Weibel,Inman,Unanimous,Cartlidge,29,28,Collett,30,27,Lethaby,29,28,1,3,1
2014-02-15,3,Hewitt,Else,Hewitt,Unanimous,Cartlidge,30,27,Collett,30,27,Lethaby,30,27,3,3,3
2014-02-15,3,Watts,Kerr,Watts,Unanimous,Cartlidge,29,28,Collett,29,28,Lethaby,30,27,1,1,3
2014-02-15,5,Machida,Mousasi,Machida,Unanimous,Bertrand,49,46,Lins,50,45,Weeks,50,45,3,5,5
2014-02-15,3,Carmont,Souza,Souza,Unanimous,Bertrand,28,29,Borges,27,30,Weeks,28,29,-1,-3,-1
2014-02-15,3,Musoke,Andrade,Musoke,Unanimous,Bertrand,29,28,Borges,29,28,Lins,29,28,1,1,1
2014-02-15,3,Proctor,Marcello,Proctor,Unanimous,Bertrand,29,28,Borges,29,28,Weeks,29,28,1,1,1
2014-02-15,3,Jorge,Damm,Damm,Unanimous,Bertrand,28,29,Borges,28,29,Lins,28,29,-1,-1,-1
2014-02-15,3,Ronson,Trinaldo,Trinaldo,Split,Borges,29,28,Lins,28,29,Weeks,27,30,1,-1,-3
2014-02-15,3,Reis,Alcântara,Alcântara,Split,Bertrand,27,30,Lins,27,30,Weeks,29,28,-3,-3,1
2014-02-15,3,Arantes,Blanco,Arantes,Unanimous,Bertrand,29,27,Borges,29,27,Weeks,29,27,2,2,2
2014-02-15,3,Alcântara,Tumenov,Alcântara,Split,Borges,28,29,Lins,30,27,Weeks,29,28,-1,3,1
2014-02-15,3,Tukhugov,Silva de Andrade,Tukhugov,Unanimous,Bertrand,29,28,Borges,30,27,Lins,30,27,1,3,3
2014-02-01,5,Aldo,Lamas,Aldo,Unanimous,Almeida,49,46,Colón,49,46,Urso,49,46,3,3,3
2014-02-01,3,Mir,Overeem,Overeem,Unanimous,Agustin,27,30,Tamburrino,27,30,Tirelli,27,30,-3,-3,-3
2014-02-01,3,Bagautinov,Lineker,Bagautinov,Unanimous,Agustin,29,28,Sanidad,29,28,Tirelli,29,28,1,1,1
2014-02-01,3,Patrick,Makdessi,Patrick,Unanimous,Almeida,29,28,Sanidad,29,28,Urso,30,27,1,1,3
2014-02-01,3,Martinez,Cariaso,Cariaso,Unanimous,Agustin,28,29,Colón,28,29,Tamburrino,28,29,-1,-1,-1
2014-02-01,3,Catone,Watson,Catone,Split,Agustin,30,27,Tamburrino,29,28,Urso,28,29,3,1,-1
2014-02-01,3,Iaquinta,Lee,Iaquinta,Unanimous,Agustin,29,28,Colón,29,28,Tirelli,28,27,1,1,1
2014-02-01,3,Enz,Hester,Hester,Unanimous,Sanidad,27,30,Tamburrino,26,30,Urso,27,30,-3,-4,-3
2014-02-01,3,Martin,Magomedov,Magomedov,Unanimous,Almeida,28,29,Colón,28,29,Urso,28,29,-1,-1,-1
2014-02-01,3,Magny,Umalatov,Magny,Unanimous,Almeida,29,28,Sanidad,30,27,Tirelli,30,27,1,3,3
2014-01-25,5,Henderson,Thomson,Henderson,Split,D'Amato,49,46,Puccillo,48,47,Sabaitis,47,48,3,1,-1
2014-01-25,3,Miocic,Gonzaga,Miocic,Unanimous,D'Amato,30,27,Goodman,29,28,Weeks,30,27,3,1,3
2014-01-25,3,Elkins,Stephens,Stephens,Unanimous,D'Amato,28,29,Puccillo,27,30,Sabaitis,27,30,-1,-3,-3
2014-01-25,3,Meza,Camus,Camus,Unanimous,Caldwell,27,30,D'Amato,28,29,Sabaitis,28,29,-3,-1,-1
2014-01-25,3,Viana,Hernandez,Viana,Unanimous,Caldwell,29,28,D'Amato,29,28,Puccillo,29,28,1,1,1
2014-01-25,3,Sullivan,Rhodes,Sullivan,Unanimous,D'Amato,29,28,Sabaitis,29,28,Weeks,29,28,1,1,1
2014-01-18,3,Bollinger,Nam,Bollinger,Unanimous,Bertrand,29,28,Gomez,29,28,Vannatta,29,28,1,1,1
2014-01-18,3,Mehmen,Barrett,Mehmen,Unanimous,Bertrand,30,27,Gomez,29,28,Rodriguez,29,28,3,1,1
2014-01-18,3,Vila,Honorio,Vila,Unanimous,Gomez,29,28,Rodriguez,30,27,Vannatta,29,28,1,3,1
2014-01-18,3,Assunção,Hansen,Assunção,Split,Bertrand,29,28,Gomez,28,29,Rodriguez,29,28,1,-1,1
2014-01-15,3,Tavares,Larkin,Tavares,Unanimous,Bertrand,29,28,Cleary,29,28,Trowbridge,29,28,1,1,1
2014-01-15,3,Easton,Dillashaw,Dillashaw,Unanimous,Cleary,27,30,Lee,27,30,Trowbridge,27,30,-3,-3,-3
2014-01-15,3,Moraga,Ortiz,Moraga,Split,Bertrand,29,28,Mann,29,28,Trowbridge,28,29,1,1,-1
2014-01-15,3,Edwards,Nijem,Nijem,Unanimous,Cleary,28,29,Coffey,27,30,Trowbridge,28,29,-1,-3,-1
2014-01-15,3,Silverio,Vallie-Flagg,Silverio,Unanimous,Bertrand,29,27,Lee,29,27,Mann,29,27,2,2,2
2014-01-15,3,Houston,Smith,Smith,Split,Bertrand,28,29,Cleary,29,28,Coffey,28,29,-1,1,-1
2014-01-15,3,Smolka,Ozkilic,Smolka,Unanimous,Cleary,29,28,Lee,29,28,Mann,29,28,1,1,1
2014-01-15,3,Whiteley,Pichel,Pichel,Unanimous,Bertrand,27,30,Coffey,27,30,Trowbridge,27,30,-3,-3,-3
2014-01-04,5,Saffiedine,Lim,Saffiedine,Unanimous,Cartlidge,48,47,Collett,49,46,Dimitriou,48,47,1,3,1
2014-01-04,3,Kikuno,Mulhern,Kikuno,Unanimous,Cartlidge,30,27,Collett,30,27,Keech,30,27,3,3,3
2014-01-04,3,Galera,Wee,Wee,Unanimous,Cartlidge,26,30,Dimitriou,26,30,Foley,26,30,-4,-4,-4
2014-01-04,3,Bang,Taisumov,Taisumov,Unanimous,Collett,27,30,Dimitriou,27,30,Keech,27,30,-3,-3,-3
2013-12-31,3,Mulpeter,Maguire,Maguire,Unanimous,Cartlidge,28,29,Lethaby,28,29,Oglesby,28,29,-1,-1,-1
2013-12-31,3,English,Vitaly,English,Unanimous,Cartlidge,29,28,Lethaby,30,27,Mitchell,30,27,1,3,3
2013-12-31,3,Boujard,Queally,Boujard,Unanimous,Cartlidge,29,28,Goddard,29,28,Lethaby,29,28,1,1,1
2013-12-31,3,Sheehan,Kelly,Kelly,Unanimous,Cartlidge,28,29,Lethaby,28,29,Oglesby,28,30,-1,-1,-2
2013-12-28,3,Siver,Gamburyan,Siver,Unanimous,Collins,29,28,Hagen,29,28,Kamijo,29,28,1,1,1
2013-12-28,3,Bahadurzada,Howard,Howard,Unanimous,Byrd,27,30,Kamijo,27,30,Lee,27,30,-3,-3,-3
2013-12-28,3,Patolino,Voelker,Patolino,Unanimous,Collins,30,27,Morse Jarman,30,27,Silbert,30,27,3,3,3
2013-12-14,3,Lentz,Mendes,Mendes,Unanimous,Bell,28,29,Cleary,27,30,Vierra,27,30,-1,-3,-3
2013-12-14,3,Lauzon,Danzig,Lauzon,Unanimous,Bell,30,27,Collantes,30,27,Rosales,30,27,3,3,3
2013-12-14,3,McGee,LaFlare,LaFlare,Unanimous,Collantes,28,29,Rosales,28,29,Vierra,28,29,-1,-1,-1
2013-12-14,3,Castillo,Barboza,Barboza,Majority,Bell,28,29,Cleary,28,28,Vierra,28,29,-1,0,-1
2013-12-14,3,Green,Healy,Green,Unanimous,Bell,29,28,Cleary,30,27,Collantes,30,27,1,3,3
2013-12-14,3,Makovsky,Jorgensen,Makovsky,Unanimous,Bell,30,27,Collantes,30,27,Rosales,30,27,3,3,3
2013-12-14,3,Stout,McKenzie,Stout,Unanimous,Bell,30,27,Cleary,30,27,Vierra,30,27,3,3,3
2013-12-14,3,Ozkilic,Uyenoyama,Ozkilic,Split,Bell,29,28,Collantes,28,29,Rosales,30,27,1,-1,3
2013-12-13,3,Brum,Pekov,Brum,Unanimous,Cartlidge,29,28,Lethaby,29,28,Ryan,29,28,1,1,1
2013-12-13,3,Seck,Mason,Mason,Unanimous,Cartlidge,28,29,Lethaby,28,29,Ryan,27,30,-1,-1,-3
2013-12-13,3,del Guerra,Bostwick,Bostwick,Unanimous,Cartlidge,28,29,Lethaby,28,29,Ryan,28,29,-1,-1,-1
2013-12-13,3,Brown,Boussuge,Boussuge,Unanimous,Cartlidge,28,29,Lethaby,27,30,Ryan,27,30,-1,-3,-3
2013-12-07,3,Pastor,Fishgold,Fishgold,Unanimous,Cartlidge,28,29,Lethaby,28,29,Sledge,28,29,-1,-1,-1
2013-12-07,3,Howarth,Delaney,Howarth,Split,Cartlidge,28,29,Lethaby,29,28,Sledge,30,27,-1,1,3
2013-12-07,3,Niedzwiedz,Hughes,Niedzwiedz,Unanimous,Cartlidge,29,28,Lethaby,29,28,Sledge,29,28,1,1,1
2013-12-07,3,Haque,Connor,Haque,Unanimous,Cartlidge,30,27,Lethaby,30,27,Sledge,30,27,3,3,3
2013-12-07,5,Honchak,Smith,Honchak,Unanimous,Gueary,49,46,Harper,49,46,Swanberg,49,46,3,3,3
2013-12-07,3,Herrig,Torres,Torres,Unanimous,Gueary,27,30,Miller,27,30,Swanberg,27,30,-3,-3,-3
2013-12-07,3,Kankaanpää,Wood,Wood,Unanimous,Gueary,28,29,Harper,28,29,Swanberg,28,29,-1,-1,-1
2013-12-07,3,Budd,Tweet,Budd,Unanimous,Gueary,30,27,Harper,30,27,Miller,30,27,3,3,3
2013-12-07,3,Frausto Gurgel,Porto,Porto,Unanimous,Harper,28,29,Miller,28,29,Swanberg,27,30,-1,-1,-3
2013-12-07,3,D'Alelio,Evinger,Evinger,Unanimous,Gueary,28,29,Miller,28,29,Swanberg,28,29,-1,-1,-1
2013-12-07,3,Bader,Perosh,Bader,Unanimous,Dimitriou,30,27,Hickmott,30,26,Kleynjans,30,27,3,4,3
2013-12-07,3,Correia,Kedzie,Correia,Split,Foley,29,28,Hickmott,28,29,Keech,29,28,1,-1,1
2013-12-07,3,Phan,Mizugaki,Mizugaki,Unanimous,Dimitriou,28,30,Kleynjans,28,29,Papaioannou,28,29,-2,-1,-1
2013-12-07,3,Magalhães,Ring,Magalhães,Unanimous,Hickmott,29,28,Kleynjans,29,28,Papaioannou,29,28,1,1,1
2013-12-07,3,Jotko,Santos,Jotko,Unanimous,Dimitriou,29,28,Hickmott,29,28,Papaioannou,30,27,1,1,3
2013-12-07,3,Taylor,Mutapcic,Taylor,Unanimous,Cadlick,30,27,Mccallister,30,27,Welch,30,27,3,3,3
2013-12-07,3,Albrecht,Solorio,Solorio,Unanimous,Cadlick,28,29,Mccallister,28,29,Welch,28,29,-1,-1,-1
2013-12-07,3,Merola,Ring,Merola,Unanimous,Cadlick,29,27,Mccallister,29,27,Welch,29,27,2,2,2
2013-12-07,3,Saidov,Acácio,Saidov,Unanimous,Pawlega,30,27,Rysiewski,30,28,Wojciechowski,30,28,3,2,2
2013-12-07,3,Horwich,Strus,Strus,Majority,Bonkowski,28,29,Preiss,28,28,Rysiewski,27,29,-1,0,-2
2013-12-07,5,Silva,Hunt,draw,Majority,Foley,47,47,Keech,47,48,Papaioannou,47,47,0,-1,0
2013-11-30,3,Duke,Morgan,Duke,Unanimous,Byrd,30,27,Morse Jarman,30,27,Weeks,30,27,3,3,3
2013-11-30,3,Modafferi,Pennington,Pennington,Unanimous,Crosby,28,29,Lee,27,30,Trowbridge,27,30,-1,-3,-3
2013-11-30,3,Yahya,Niinimäki,Niinimäki,Split,Lee,28,29,Morse Jarman,29,28,Weeks,27,30,-1,1,-3
2013-11-30,3,Harris,Rosholt,Rosholt,Unanimous,Crosby,28,29,Smith,28,29,Trowbridge,28,29,-1,-1,-1
2013-11-30,3,Dober,Spencer,Spencer,Unanimous,Crosby,27,30,Kamijo,27,30,Morse Jarman,27,30,-3,-3,-3
2013-11-22,3,Sarnavskiy,Brooks,Brooks,Unanimous,Colflesh,27,30,Hanlon,26,30,Urso,27,30,-3,-4,-3
2013-11-22,3,Cenoble,Etim,Etim,Unanimous,Cintron,28,29,Hanlon,27,30,Urso,26,30,-1,-3,-4
2013-11-16,5,St-Pierre,Hendricks,St-Pierre,Split,D'Amato,48,47,Trowbridge,47,48,Weeks,48,47,1,-1,1
2013-11-16,3,MacDonald,Lawler,Lawler,Split,Peoples,28,29,Smith,28,29,Trowbridge,29,28,-1,-1,1
2013-11-16,3,Elliott,Bagautinov,Bagautinov,Unanimous,Byrd,28,29,D'Amato,28,29,Trowbridge,27,30,-1,-1,-3
2013-11-16,3,Leites,Herman,Leites,Unanimous,Byrd,30,27,Morse Jarman,30,27,Trowbridge,30,27,3,3,3
2013-11-16,3,Story,Ebersole,Story,Unanimous,Kamijo,30,27,Peoples,30,27,Smith,30,27,3,3,3
2013-11-16,3,Perez,Figueroa,Perez,Unanimous,Byrd,30,27,D'Amato,30,27,Kamijo,30,27,3,3,3
2013-11-16,3,High,Lapsley,High,Unanimous,Morse Jarman,29,28,Peoples,29,28,Weeks,29,28,1,1,1
2013-11-16,3,Pettis,Campuzano,Pettis,Unanimous,D'Amato,29,28,Peoples,30,27,Smith,30,27,1,3,3
2013-11-15,3,Burrell,Martinez,Burrell,Unanimous,Barry,30,27,Bilyk,30,27,Sinclair,29,28,3,3,1
2013-11-15,3,Foster,Morrison,Morrison,Majority,Colón,27,29,Tamburrino,26,30,Urso,28,28,-2,-4,0
2013-11-15,3,Sullivan,da Silva,Sullivan,Unanimous,Colón,29,28,Sinclair,30,27,Tamburrino,30,27,1,3,3
2013-11-09,3,Sarafian,Ferreira,Ferreira,Split,Crosby,28,30,Rosales,29,28,Torriero,27,30,-2,1,-3
2013-11-09,3,LaFlare,Ponzinibbio,LaFlare,Unanimous,Crosby,30,27,Rosales,30,27,Torriero,30,27,3,3,3
2013-11-08,3,Jones,White,Jones,Unanimous,Hatley,29,28,Mathisen,29,28,Montalvo,29,28,1,1,1
2013-11-08,3,Graham,Kongo,Kongo,Unanimous,Mathisen,27,30,Montalvo,27,30,Turnage,27,30,-3,-3,-3
2013-11-08,3,Campos,Stapleton,Campos,Unanimous,Mathisen,30,27,Montalvo,30,27,Turnage,30,27,3,3,3
2013-11-08,3,Berto,Freire,Freire,Unanimous,Mathisen,27,30,Montalvo,28,29,Turnage,27,30,-3,-1,-3
2013-11-08,3,Billstein,Coleman,Billstein,Unanimous,Mathisen,30,27,Montalvo,30,27,Turnage,30,27,3,3,3
2013-11-08,3,Mucitelli,McCurdy,Mucitelli,Unanimous,Mathisen,29,28,Montalvo,29,28,Turnage,29,28,1,1,1
2013-11-08,3,Vassell,Jones,Vassell,Unanimous,Hatley,30,27,Mathisen,30,26,Montalvo,30,26,3,4,4
2013-11-06,3,Davis,Carmouche,Davis,Unanimous,Brockmole,29,28,Evans,30,27,Kinman,30,27,1,3,3
2013-11-06,3,Masvidal,Khabilov,Khabilov,Unanimous,Brockmole,27,30,Kinman,28,29,Lee,27,30,-3,-1,-3
2013-11-06,3,Bermudez,Siler,Bermudez,Unanimous,Brockmole,30,27,Evans,30,27,Kinman,30,27,3,3,3
2013-11-06,3,Larkin,Camozzi,Larkin,Unanimous,D'Amato,29,28,Lee,30,27,Urso,30,27,1,3,3
2013-11-06,3,Magny,Baczynski,Baczynski,Unanimous,Evans,28,29,Kinman,28,29,Lee,28,29,-1,-1,-1
2013-11-02,5,Chandler,Alvarez,Alvarez,Split,Beltran,48,47,Cleary,47,48,Davis,47,48,1,-1,-1
2013-11-02,5,Lawal,Newton,Newton,Unanimous,Cleary,46,49,Davis,46,49,Lebell,46,49,-3,-3,-3
2013-11-02,5,Curran,Straus,Straus,Unanimous,Beltran,46,48,Cleary,45,49,Mccarthy,46,48,-2,-4,-2
2013-11-02,3,Bronzoulis,Riggs,Riggs,Unanimous,Cleary,27,30,Davis,27,30,Lebell,27,30,-3,-3,-3
2013-11-02,3,Luciano,Camacho,Luciano,Unanimous,Cleary,30,27,Davis,30,27,Lebell,30,27,3,3,3
2013-11-02,3,Smith,Smith,Smith,Unanimous,Beltran,28,29,Lebell,28,29,Mccarthy,28,29,-1,-1,-1
2013-10-26,3,Fitch,Alfaya,Fitch,Split,Green,28,29,Rodriguez,29,28,Vannatta,29,28,-1,1,1
2013-10-26,3,Firmino,Volkmann,Firmino,Unanimous,Green,29,28,Rodriguez,30,27,Vannatta,29,28,1,3,1
2013-10-26,3,Vila,Rettinghouse,Rettinghouse,Unanimous,Green,28,29,Rodriguez,28,29,Vannatta,28,29,-1,-1,-1
2013-10-26,3,Tuck,Parke,Parke,Unanimous,Cartlidge,28,29,Hughes,27,30,Watts,28,29,-1,-3,-1
2013-10-26,3,Hallmann,Iaquinta,Iaquinta,Unanimous,Cartlidge,28,29,Hughes,27,30,Roberts,27,30,-1,-3,-3
2013-10-26,3,Andrade,Sexton,Andrade,Unanimous,Cartlidge,30,26,Hughes,30,27,Watts,30,26,4,3,4
2013-10-26,3,Ogle,Miller,Miller,Unanimous,Hughes,28,29,Roberts,28,29,Watts,28,29,-1,-1,-1
2013-10-26,3,France,Stringer,draw,Unanimous,Rodriguez,28,28,Streisand,28,28,Vannatta,28,28,0,0,0
2013-10-25,3,Brooks,Awad,Brooks,Unanimous,Porrata,30,27,Saavedra,30,27,Sanchez,30,27,3,3,3
2013-10-24,3,Mann,Pekov,Mann,Unanimous,Lethaby,30,27,Oglesby,29,28,Sledge,30,27,3,1,3
2013-10-24,3,Roddy,Gonzalez,Roddy,Split,Lethaby,28,29,Oglesby,29,28,Sledge,29,28,-1,1,1
2013-10-24,3,Marin,Haque,Marin,Unanimous,Lethaby,29,28,Oglesby,30,27,Sledge,30,27,1,3,3
2013-10-19,3,Cormier,Nelson,Cormier,Unanimous,Garcia,30,27,Najera,30,27,Schorle,30,27,3,3,3
2013-10-19,3,Melendez,Sanchez,Melendez,Unanimous,D'Amato,30,27,Turnage,29,28,Wincapaw,29,28,3,1,1
2013-10-19,3,Boetsch,Dollaway,Boetsch,Split,Garcia,27,29,Najera,30,26,Schorle,30,26,-2,4,4
2013-10-19,3,Kaufman,Eye,Eye,Split,Garcia,29,28,Najera,28,29,Schorle,28,29,1,-1,-1
2013-10-19,3,Sotiropoulos,Noons,Noons,Unanimous,D'Amato,28,29,Turnage,27,30,Wincapaw,28,29,-1,-3,-1
2013-10-18,3,Hawn,Weedman,Hawn,Unanimous,Caldwell,30,27,Malott,30,27,Torriero,30,27,3,3,3
2013-10-18,3,Grove,Vedepo,Grove,Unanimous,Caldwell,29,28,D'Amato,30,27,Malott,30,27,1,3,3
2013-10-18,3,Prindle,Graham,Graham,Unanimous,D'Amato,26,30,Malott,27,30,Torriero,27,30,-4,-3,-3
2013-10-18,3,Bradley,Amoussou,Bradley,Unanimous,Caldwell,29,28,Malott,29,28,Torriero,29,28,1,1,1
2013-10-11,3,Guerreiro,Freire,Freire,Unanimous,Champion,27,30,Miller-Pence,27,30,Pilgrim,27,30,-3,-3,-3
2013-10-11,3,Wilcox,Taimanglo,Wilcox,Unanimous,Belshe,30,27,Champion,30,27,Miller-Pence,29,28,3,3,1
2013-10-11,3,Bussieres,Pool,Bussieres,Unanimous,Belshe,29,28,Champion,29,28,Miller-Pence,30,27,1,1,3
2013-10-11,3,Saudino,Thornton,Saudino,Split,Champion,29,28,Miller-Pence,29,28,Pilgrim,28,29,1,1,-1
2013-10-09,5,Shields,Maia,Shields,Split,Bertrand,48,47,Bravo,47,48,D'Amato,48,47,1,-1,1
2013-10-09,3,Hamill,Silva,Silva,Unanimous,Bertrand,27,30,D'Amato,27,29,Puccillo,27,30,-3,-2,-3
2013-10-09,3,Maldonado,Beltran,Maldonado,Split,Bertrand,28,29,Bravo,29,28,D'Amato,29,28,-1,1,1
2013-10-09,3,Assuncao,Dillashaw,Assuncao,Split,Bertrand,29,28,D'Amato,28,29,Puccillo,29,28,1,-1,1
2013-10-09,3,Araujo,Alcântara,Araujo,Unanimous,Bertrand,29,28,Bravo,29,28,D'Amato,29,28,1,1,1
2013-10-09,3,Cabral,Mitchell,Cabral,Unanimous,Bravo,30,27,D'Amato,30,27,Puccillo,30,27,3,3,3
2013-10-05,3,Blackwell,Edwards,Blackwell,Split,Cartlidge,29,28,Lethaby,28,29,Oglesby,30,27,1,-1,3
2013-10-05,3,Constatine,Watts,Watts,Split,Cartlidge,29,28,Lethaby,28,29,Oglesby,28,29,1,-1,-1
2013-10-04,3,Silva,Leone,Silva,Unanimous,Lawley,30,27,Mcknight,30,27,Rosales,30,27,3,3,3
2013-10-04,3,Butcher,Parlo,Parlo,Unanimous,Belardo,28,29,Lawley,28,29,Rosales,27,30,-1,-1,-3
2013-09-28,3,Soukupova,Kowalkiewicz,Kowalkiewicz,Unanimous,Pawlega,26,30,Preiss,27,30,Wojciechowski,27,30,-4,-3,-3
2013-09-28,3,Gamrot,Winner,Gamrot,Unanimous,Grela,30,28,Pawlega,30,28,Rysiewski,30,27,2,2,3
2013-09-27,3,Clementi,Tirloni,Tirloni,Unanimous,Dinger,26,30,Enright,27,30,Priollaud,27,30,-4,-3,-3
2013-09-27,3,Brooks,Alessio,Brooks,Unanimous,Dinger,30,26,Enright,30,25,Gregory,30,27,4,5,3
2013-09-27,3,Coy,Uhrich,Coy,Unanimous,Dinger,29,28,Enright,29,28,Gregory,29,28,1,1,1
2013-09-27,3,Skinner,Springer,Springer,Unanimous,Enright,26,30,Gregory,28,29,Priollaud,28,29,-4,-1,-1
2013-09-27,3,Aspinwal,Riggs,Aspinwal,Split,Dinger,29,28,Enright,28,29,Priollaud,29,28,1,-1,1
2013-09-21,5,Gustafsson,Jones,Jones,Unanimous,Bertrand,47,48,Crosby,47,48,Lee,46,49,-1,-1,-3
2013-09-21,3,Carmont,Philippou,Carmont,Unanimous,Bertrand,30,27,Crosby,30,27,D'Amato,30,26,3,3,4
2013-09-21,3,Healy,Nurmagomedov,Nurmagomedov,Unanimous,Bertrand,27,30,Crosby,27,30,D'Amato,27,30,-3,-3,-3
2013-09-21,3,Jury,Ricci,Jury,Split,Bertrand,29,28,Crosby,28,29,Lee,29,28,1,-1,1
2013-09-21,3,Menjivar,Reis,Reis,Unanimous,Bertrand,28,29,D'Amato,28,29,Lee,28,29,-1,-1,-1
2013-09-21,3,Prazeres,Ronson,Prazeres,Split,Beauchamp,28,29,Bettes,29,28,Roussel,29,28,-1,1,1
2013-09-21,3,Caceres,Delorme,Caceres,Split,Beauchamp,28,29,Bettes,29,28,Roussel,29,28,-1,1,1
2013-09-18,3,Escudero,Surdyka,Escudero,Unanimous,Flores,30,27,Gabauer,30,27,Perrault,30,27,3,3,3
2013-09-18,3,Terrado,Hawn,Hawn,Unanimous,Flores,28,29,Gabauer,27,30,Perrault,28,29,-1,-3,-1
2013-09-18,3,Keslar,Melo,Keslar,Split,Gabauer,29,28,Harmon,29,28,Perrault,28,29,1,1,-1
2013-09-18,3,Starks,Yager,Starks,Unanimous,Flores,30,27,Gabauer,29,28,Perrault,30,27,3,1,3
2013-09-14,3,Arlovski,Kyle,Arlovski,Unanimous,Colón,29,28,Tamburrino,29,28,Urso,29,28,1,1,1
2013-09-14,3,Branch,Villefort,Branch,Unanimous,Depasquale Jr.,30,27,Tirelli,30,27,Urso,30,27,3,3,3
2013-09-14,3,Glenn,Rofi,Glenn,Unanimous,Colón,29,28,Depasquale Jr.,29,28,Tirelli,29,28,1,1,1
2013-09-14,3,Rivera,Honorio,Rivera,Unanimous,Colón,29,28,Depasquale Jr.,30,27,Sinclair,29,28,1,3,1
2013-09-14,3,Gracie,Patishnock,Patishnock,Unanimous,Tamburrino,28,29,Tirelli,27,30,Urso,28,29,-1,-3,-1
2013-09-14,5,Desborough,Johns,Johns,Split,Cartlidge,48,47,Lethaby,47,48,Sledge,47,48,1,-1,-1
2013-09-14,5,Alers,Svensson,Alers,Unanimous,Cartlidge,48,47,Lethaby,49,46,Sledge,49,46,1,3,3
2013-09-14,3,Hill,Moore,Hill,Unanimous,Cartlidge,29,28,Lethaby,30,27,Sledge,30,28,1,3,2
2013-09-14,3,Johns,Haggstrom,Johns,Unanimous,Cartlidge,29,28,Lethaby,29,28,Sledge,30,27,1,1,3
2013-09-14,3,Rogers,Caswell,Caswell,Unanimous,Cartlidge,27,29,Lethaby,27,29,Sledge,27,29,-2,-2,-2
2013-09-14,12,Mayweather,Álvarez,Mayweather,Majority,Metcalfe,117,111,Moretti,116,112,Ross,114,114,6,4,0
2013-09-13,3,Guerreiro,Green,Guerreiro,Unanimous,Denkin,29,28,Griffin,29,28,Herzog,29,28,1,1,1
2013-09-13,3,Matyushenko,Alexander,Matyushenko,Unanimous,Beltran,29,28,Denkin,30,27,Griffin,30,27,1,3,3
2013-09-13,3,Taimanglo,Fisher,Taimanglo,Unanimous,Dean,29,28,Denkin,30,27,Griffin,30,27,1,3,3
2013-09-13,3,Sterritt,Murad,Sterritt,Split,Dean,28,29,Denkin,29,28,Griffin,29,28,-1,1,1
2013-09-13,3,Kosic,Ramirez,Ramirez,Unanimous,Denkin,27,30,Griffin,27,30,Herzog,27,30,-3,-3,-3
2013-09-07,5,Cooper,Shlemenko,Shlemenko,Unanimous,Colón,47,48,Tirelli,47,48,Urso,47,48,-1,-1,-1
2013-09-07,3,Parlo,Rogers,Parlo,Unanimous,Colón,30,27,Tirelli,30,26,Urso,30,26,3,4,4
2013-09-07,3,Anderson,Freire,Anderson,Unanimous,Colón,29,28,Tirelli,29,28,Urso,29,28,1,1,1
2013-09-04,3,Natal,Troeng,Natal,Unanimous,Cartlidge,30,27,Hughes,30,27,Silbert,29,28,3,3,1
2013-09-04,3,Arantes,Souza,Souza,Split,Hughes,29,28,Silbert,28,29,Trowbridge,28,29,1,-1,-1
2013-09-04,3,Zeferino,Silverio,Silverio,Unanimous,Cartlidge,28,29,Hughes,27,30,Silbert,27,30,-1,-3,-3
2013-09-04,3,Wisniewski,Jorge,Jorge,Unanimous,Bravo,28,29,Silbert,28,29,Trowbridge,27,30,-1,-1,-3
2013-09-04,3,Spencer,Villefort,Spencer,Split,Bravo,30,27,Cartlidge,29,28,Hughes,28,29,3,1,-1
2013-08-31,3,Koch,Poirier,Poirier,Unanimous,D'Amato,27,29,Lee,27,29,Torriero,28,29,-2,-2,-1
2013-08-31,3,Varner,Tibau,Tibau,Split,D'Amato,28,29,Puccillo,28,29,Torriero,29,27,-1,-1,2
2013-08-31,3,Gaudinot,Elliott,Elliott,Unanimous,Clancy,27,30,Lee,26,30,Winter,26,30,-3,-4,-4
2013-08-31,3,Kang,Camus,Camus,Unanimous,D'Amato,28,29,Lee,28,29,Winter,27,30,-1,-1,-3
2013-08-31,3,Couture,Iaquinta,Iaquinta,Unanimous,D'Amato,27,30,Puccillo,27,30,Torriero,27,30,-3,-3,-3
2013-08-28,3,Cerrone,dos Anjos,dos Anjos,Unanimous,D'Amato,28,29,Madrigal,28,29,Trowbridge,28,29,-1,-1,-1
2013-08-28,3,Whittaker,McGee,McGee,Split,Caldwell,30,27,D'Amato,27,30,Madrigal,28,29,3,-3,-1
2013-08-28,3,Mizugaki,Perez,Mizugaki,Split,Caldwell,29,28,Hinkel,29,28,Trowbridge,28,29,1,1,-1
2013-08-28,3,McDaniel,Tavares,Tavares,Unanimous,Crosby,28,29,D'Amato,28,29,Silbert,28,29,-1,-1,-1
2013-08-28,3,Hioki,Elkins,Elkins,Unanimous,D'Amato,28,29,Silbert,28,29,Trowbridge,28,29,-1,-1,-1
2013-08-24,3,Andrade,Abbasov,Abbasov,Unanimous,Cartlidge,27,30,Lethaby,27,30,Sledge,27,30,-3,-3,-3
2013-08-24,3,Mamedov,James,James,Unanimous,Cartlidge,27,30,Lethaby,27,30,Sledge,28,29,-3,-3,-1
2013-08-24,3,Tukhugov,Pidnebesnyi,Tukhugov,Unanimous,Cartlidge,30,27,Lethaby,30,27,Sledge,30,27,3,3,3
2013-08-17,3,Alcântara,Faber,Faber,Unanimous,D'Amato,26,30,Miner,26,30,Shea,27,30,-4,-4,-3
2013-08-17,3,Hall,Howard,Howard,Split,Crosby,28,29,Rita,29,28,Shea,27,30,-1,1,-3
2013-08-17,3,Johnson,Lauzon,Johnson,Unanimous,D'Amato,30,27,Miner,30,27,Weeks,30,25,3,3,5
2013-08-17,3,Holloway,McGregor,McGregor,Unanimous,Rita,27,30,Shea,26,30,Weeks,27,30,-3,-4,-3
2013-08-17,3,Brandão,Pineda,Brandão,Unanimous,Crosby,29,28,Ginsberg,29,28,Shea,29,28,1,1,1
2013-08-17,3,Miller,Gamburyan,Gamburyan,Unanimous,D'Amato,28,29,Rita,27,30,Weeks,28,29,-1,-3,-1
2013-08-10,3,DeAnda,Spong,Spong,Unanimous,Landless,27,30,Lawley,28,29,Lebell,27,30,-3,-1,-3
2013-08-10,3,Hempleman,Moraes,Moraes,Unanimous,Landless,27,30,Lawley,27,30,Lebell,27,30,-3,-3,-3
2013-08-10,3,Harris,Santiago,Harris,Unanimous,Landless,29,27,Lawley,29,27,Lebell,29,27,2,2,2
2013-08-10,3,Gonzalez,McKee,Gonzalez,Unanimous,Landless,29,28,Lawley,29,28,Lebell,29,28,1,1,1
2013-08-10,3,Papazian,Robles,Papazian,Unanimous,Landless,30,27,Lawley,29,28,Lebell,30,27,3,1,3
2013-08-03,3,Machida,Davis,Davis,Unanimous,D'Amato,28,29,Watts,28,29,Winter,28,29,-1,-1,-1
2013-08-03,3,Watson,Leites,Leites,Unanimous,Bravo,27,30,D'Amato,27,30,Winter,27,30,-3,-3,-3
2013-08-03,3,Santos,McCall,McCall,Unanimous,Collett,28,29,D'Amato,27,30,Watts,27,30,-1,-3,-3
2013-08-03,3,Yahya,Clopton,Yahya,Unanimous,Bravo,29,28,Collett,29,28,Watts,29,28,1,1,1
2013-08-03,3,Oliveira,Barroso,Barroso,Unanimous,Bravo,28,29,Collett,27,30,Winter,27,30,-1,-3,-3
2013-07-31,3,Wright Jr.,Sanchez,Sanchez,Split,Martinez,28,29,Saavedra,29,28,Sena,28,29,-1,1,-1
2013-07-31,3,Palacios,Jacques,Palacios,Unanimous,Saavedra,30,27,Sanchez,30,27,Sena,30,27,3,3,3
2013-07-31,3,Wilson,Bunch,Bunch,Split,Martinez,28,29,Sanchez,28,29,Sena,29,28,-1,-1,1
2013-07-27,3,MacDonald,Ellenberger,MacDonald,Unanimous,D'Amato,29,28,Griffin,30,27,Hagen,30,27,1,3,3
2013-07-27,3,Means,Castillo,Castillo,Unanimous,Boehlke,28,29,Hagen,28,29,Hamada,28,29,-1,-1,-1
2013-07-27,3,Edwards,Cruickshank,Cruickshank,Split,Boehlke,30,27,Griffin,27,30,Hamada,27,30,3,-3,-3
2013-07-27,3,Smith,Herman,Herman,Split,D'Amato,30,27,Griffin,28,29,Lee,27,30,3,-1,-3
2013-07-27,3,de Randamie,Kedzie,de Randamie,Split,Boehlke,30,27,Griffin,28,29,Nelson,29,28,3,-1,1
2013-07-27,3,Salas,Riley,Salas,Split,D'Amato,29,28,Lee,29,28,Nelson,28,29,1,1,-1
2013-07-21,3,Barnes,Paraisy,Paraisy,Unanimous,Cartlidge,28,29,Collett,28,29,Lethaby,27,30,-1,-1,-3
2013-07-21,3,Arish,Mason,Arish,Unanimous,Cartlidge,29,28,Collett,29,28,Lethaby,29,28,1,1,1
2013-07-21,3,Dinsdale,Rushworth,Dinsdale,Unanimous,Cartlidge,29,28,Collett,29,28,Lethaby,29,28,1,1,1
2013-07-13,3,D'Alelio,Murphy,Murphy,Unanimous,Gueary,28,29,Harper,27,30,Miller,28,29,-1,-3,-1
2013-07-13,3,Maia,Smith,Smith,Unanimous,Gueary,27,30,Miller,27,30,Swanberg,28,29,-3,-3,-1
2013-07-13,3,Rueda Center,Wood,Wood,Unanimous,Gueary,27,30,Miller,28,29,Swanberg,28,29,-3,-1,-1
2013-07-13,3,Rawlings,Inoue,Inoue,Unanimous,Gueary,28,29,Miller,28,29,Swanberg,28,29,-1,-1,-1
2013-07-13,3,Namajunas,Torres,Torres,Unanimous,Harper,27,30,Miller,28,29,Swanberg,28,29,-3,-1,-1
2013-07-13,3,Kagan,Cummins,Kagan,Split,Gueary,30,27,Harper,30,27,Miller,28,29,3,3,-1
2013-07-13,3,von Plettenberg,Catron,von Plettenberg,Unanimous,Gueary,29,28,Harper,30,27,Swanberg,29,28,1,3,1
2013-07-06,3,Berisha,Olivier,Olivier,Unanimous,Cartlidge,27,30,Lethaby,27,30,Sledge,27,30,-3,-3,-3
2013-07-06,3,Narimani,Turner,Turner,Split,Cartlidge,29,28,Lethaby,28,29,Sledge,27,30,1,-1,-3
2013-07-06,3,Guih,Wheeler,Wheeler,Unanimous,Cartlidge,28,29,Lethaby,28,29,Sledge,28,29,-1,-1,-1
2013-07-06,3,Pimblett,Calin,Pimblett,Unanimous,Cartlidge,29,28,Lethaby,30,27,Sledge,30,27,1,3,3
2013-07-06,3,Edgar,Oliveira,Edgar,Unanimous,Collins,30,27,Griffin,29,28,Kamijo,30,27,3,1,3
2013-07-06,3,Gracie,Kennedy,Kennedy,Unanimous,Byrd,27,30,Smith,28,29,Trowbridge,27,30,-3,-1,-3
2013-07-06,3,Munoz,Boetsch,Munoz,Unanimous,Kamijo,30,26,Morse Jarman,29,28,Rosales,30,27,4,1,3
2013-07-06,3,Craig,Leben,Craig,Split,Kamijo,29,28,Rosales,30,27,Smith,28,29,1,3,-1
2013-07-06,3,Parke,Tokudome,Parke,Unanimous,Byrd,29,28,Collins,30,27,Morse Jarman,30,27,1,3,3
2013-06-19,3,Skelly,Card,Skelly,Unanimous,Mathisen,29,28,Sutherland,29,28,Turnage,29,28,1,1,1
2013-06-19,3,Coleman,Berry,Berry,Split,Mathisen,29,28,Sutherland,28,29,Turnage,28,29,1,-1,-1
2013-06-19,3,Halsey,Yager,Halsey,Majority,Hatley,30,26,Mathisen,28,28,Turnage,30,26,4,0,4
2013-06-19,3,Campos,Girtz,Campos,Unanimous,Mathisen,29,28,Sutherland,29,28,Turnage,29,28,1,1,1
2013-06-15,3,Henderson,Evans,Evans,Split,D'Amato,28,29,Jackson,29,28,Lee,28,29,-1,1,-1
2013-06-15,3,Miocic,Nelson,Miocic,Unanimous,Bertrand,30,27,Lee,30,27,Rodgers,30,27,3,3,3
2013-06-15,3,Jimmo,Pokrajac,Jimmo,Unanimous,Bertrand,30,27,D'Amato,30,27,Rodgers,30,27,3,3,3
2013-06-15,3,Davis,Sexton,Davis,Unanimous,Bertrand,29,28,Lee,29,27,Rodgers,29,28,1,2,1
2013-06-15,3,Shields,Woodley,Shields,Split,Bertrand,29,28,D'Amato,29,28,Lee,27,30,1,1,-3
2013-06-15,3,Robertson,Pierson,Pierson,Majority,D'Amato,28,28,Rodgers,28,29,Signorino,28,29,0,-1,-1
2013-06-15,3,Figueroa,Delorme,Delorme,Unanimous,Bertrand,28,29,D'Amato,28,29,Lee,28,29,-1,-1,-1
2013-06-15,3,Clarke,Maguire,Clarke,Unanimous,Jackson,29,28,Lee,29,28,Signorino,29,28,1,1,1
2013-06-15,3,Pague,Jabouin,Jabouin,Split,Jackson,29,28,Rodgers,28,29,Signorino,28,29,1,-1,-1
2013-06-14,3,Volkmann,Beerbohm,Volkmann,Unanimous,Byrd,30,27,Morse Jarman,30,27,Smith,29,28,3,3,1
2013-06-14,3,Sanders,Smith,Sanders,Unanimous,Byrd,30,27,Kamijo,30,27,Morse Jarman,30,27,3,3,3
2013-06-14,3,Lauzon,Gunderson,Lauzon,Unanimous,Smith,30,27,Trowbridge,30,27,Weeks,30,27,3,3,3
2013-06-14,3,Beebe,Murphy,Beebe,Unanimous,Byrd,29,28,Kamijo,29,28,Trowbridge,29,28,1,1,1
2013-06-14,3,Mladenov,Miree,Mladenov,Unanimous,Morse Jarman,29,28,Smith,30,27,Weeks,30,27,1,3,3
2013-06-14,3,Montalvo,Hansen,Hansen,Unanimous,Kamijo,27,30,Trowbridge,27,30,Weeks,28,29,-3,-3,-1
2013-06-08,5,Materla,Grove,Materla,Unanimous,Bonkowski,39,38,Porebski,40,38,Wojciechowski,38,39,1,2,-1
2013-06-08,3,Piskorz,Simon,Simon,Unanimous,Porebski,28,30,Rysiewski,28,30,Wojciechowski,29,30,-2,-2,-1
2013-06-08,3,Alcântara,Silva,Alcântara,Unanimous,Bravo,30,27,Collett,30,27,Weir,30,27,3,3,3
2013-06-08,3,Hirota,Damm,Damm,Split,Collett,29,28,Trowbridge,28,29,Weir,28,29,1,-1,-1
2013-06-01,3,Coll,James,James,Unanimous,Cartlidge,27,30,Oglesby,27,30,Weir,27,30,-3,-3,-3
2013-06-01,3,Fields,Paraisy,draw,Majority,Cartlidge,28,28,Oglesby,28,28,Weir,29,27,0,0,2
2013-05-25,3,Noons,Cerrone,Cerrone,Unanimous,Crosby,27,30,Silbert,26,30,Smith,27,30,-3,-4,-3
2013-05-25,3,Story,Pyle,Pyle,Split,Hagen,28,29,Kamijo,28,29,Lee,29,28,-1,-1,1
2013-05-25,3,Holloway,Bermudez,Bermudez,Split,Griffin,28,29,Smith,28,29,Weeks,29,28,-1,-1,1
2013-05-25,3,Trujillo,Nurmagomedov,Nurmagomedov,Unanimous,Hagen,27,30,Lee,27,30,Silbert,27,30,-3,-3,-3
2013-05-25,3,Thompson,Burrell,Thompson,Unanimous,Griffin,29,28,Kamijo,29,28,Weeks,30,27,1,1,3
2013-05-25,3,Payan,Stephens,Stephens,Unanimous,Crosby,26,30,Hagen,27,30,Silbert,26,30,-4,-3,-4
2013-05-18,3,dos Anjos,Dunham,dos Anjos,Unanimous,Crosby,29,28,Hughes,29,28,Urso,29,28,1,1,1
2013-05-18,3,Zeferino,Natal,Natal,Unanimous,Bravo,27,30,Cartlidge,28,29,Crosby,28,29,-3,-1,-1
2013-05-18,3,Dias,Lentz,Lentz,Unanimous,Crosby,27,28,Hughes,28,29,Urso,28,29,-1,-1,-1
2013-05-18,3,Thiago,Prazeres,Thiago,Unanimous,Bravo,29,28,Crosby,29,28,Urso,29,28,1,1,1
2013-05-18,3,Maldonado,Hollett,Maldonado,Unanimous,Crosby,29,27,Hughes,29,28,Urso,29,27,2,1,2
2013-05-18,3,Formiga,Cariaso,Formiga,Unanimous,Cartlidge,29,28,Crosby,29,28,Hughes,29,28,1,1,1
2013-05-12,3,Mason,Reuter,Mason,Unanimous,Cartlidge,30,27,Sledge,30,27,Weir,30,27,3,3,3
2013-05-12,3,Brum,Pastor,Brum,Unanimous,Cartlidge,29,28,Sledge,30,27,Weir,29,28,1,3,1
2013-05-12,3,Lahdesmaki,Buschkamp,Buschkamp,Unanimous,Cartlidge,26,30,Sledge,26,30,Weir,26,30,-4,-4,-4
2013-05-12,3,Ling,Herb,Herb,Split,Cartlidge,28,29,Sledge,29,28,Weir,28,29,-1,1,-1
2013-05-04,3,Long,Glover,Long,Unanimous,Cartlidge,30,27,Lethaby,30,27,Weir,30,27,3,3,3
2013-05-04,3,Buchinger,Ball,Buchinger,Unanimous,Cartlidge,29,28,Lethaby,29,28,Weir,30,27,1,1,3
2013-05-04,3,Haque,Edwards,Haque,Split,Cartlidge,29,28,Lethaby,29,28,Weir,28,29,1,1,-1
2013-05-04,3,Rogers,Wheeler,Rogers,Split,Cartlidge,28,29,Lethaby,29,28,Weir,29,28,-1,1,1
2013-04-27,3,Belcher,Bisping,Bisping,Unanimous,Colón,27,30,Tirelli,27,30,Urso,28,29,-3,-3,-1
2013-04-27,3,Magalhães,Davis,Davis,Unanimous,Colón,27,30,Tamburrino,27,30,Tirelli,28,29,-3,-3,-1
2013-04-27,3,Villante,Saint Preux,Saint Preux,Majority,Colón,28,30,Depasquale Jr.,29,29,Tabora,29,30,-2,0,-1
2013-04-27,3,McKenzie,Garcia,McKenzie,Unanimous,Depasquale Jr.,29,28,Sanidad,30,27,Tamburrino,30,27,1,3,3
2013-04-27,3,Holobaugh,Siler,Siler,Unanimous,Sanidad,28,29,Tirelli,28,29,Urso,28,29,-1,-1,-1
2013-04-20,12,Trout,Álvarez,Álvarez,Unanimous,Christodoulou,109,118,Danesco,112,115,Shellenberger,111,116,-9,-3,-5
2013-04-20,5,Henderson,Melendez,Henderson,Split,Bell,48,47,Cleary,48,47,Vierra,47,48,1,1,-1
2013-04-20,3,Mir,Cormier,Cormier,Unanimous,Bell,27,30,Cleary,27,30,Davis,27,30,-3,-3,-3
2013-04-20,3,Larkin,Carmont,Carmont,Unanimous,Bell,28,29,Cleary,28,29,Collantes,28,29,-1,-1,-1
2013-04-20,3,Means,Masvidal,Masvidal,Unanimous,Cleary,28,29,Collantes,28,29,Davis,28,29,-1,-1,-1
2013-04-13,3,Scott,Nilsson,Nilsson,Unanimous,Cartlidge,27,30,Lethaby,28,29,Sledge,28,29,-3,-1,-1
2013-04-13,3,Gastelum,Hall,Gastelum,Split,Byrd,29,28,D'Amato,28,29,Kamijo,29,28,1,-1,1
2013-04-13,3,Barnatt,Hart,Barnatt,Unanimous,D'Amato,29,28,Kamijo,29,28,Weeks,30,27,1,1,3
2013-04-13,3,Blanco,Sicilia,Blanco,Unanimous,Byrd,29,28,Smith,29,28,Weeks,29,28,1,1,1
2013-04-06,3,Latifi,Mousasi,Mousasi,Unanimous,Bergman,27,30,Collett,27,30,Roberts,27,30,-3,-3,-3
2013-04-06,3,Pickett,Easton,Pickett,Split,Collett,30,27,Hughes,30,27,Ramsby,28,29,3,3,-1
2013-04-06,3,Peralta,Corassani,Corassani,Unanimous,Bergman,27,30,Collett,28,29,Hughes,27,30,-3,-1,-3
2013-04-06,3,Amagov,Spang,Amagov,Unanimous,Bergman,30,27,Collett,30,27,Hughes,30,27,3,3,3
2013-04-06,3,LaFlare,Alloway,LaFlare,Unanimous,Hughes,30,27,Ramsby,30,27,Roberts,30,27,3,3,3
2013-04-06,3,Yousef,Abedi,Abedi,Split,Bergman,28,29,Hughes,28,29,Ramsby,29,28,-1,-1,1
2013-04-05,5,Porto,Honchak,Honchak,Unanimous,Harper,46,49,Miller,47,48,Swanberg,45,50,-3,-1,-5
2013-04-05,3,Smith,Kaufman,Kaufman,Split,Gueary,28,29,Miller,29,28,Swanberg,28,29,-1,1,-1
2013-04-05,3,Frausto Gurgel,Maia,Maia,Unanimous,Gueary,27,30,Harper,28,29,Swanberg,28,29,-3,-1,-1
2013-04-05,3,Young,Murphy,Murphy,Unanimous,Harper,28,29,Miller,28,29,Swanberg,28,29,-1,-1,-1
2013-04-05,3,Kankaanpää,Lima,Kankaanpää,Unanimous,Gueary,30,27,Harper,30,27,Miller,29,28,3,3,1
2013-04-04,3,Richman,Khasbulaev,Khasbulaev,Unanimous,Colón,27,30,Tamburrino,27,30,Urso,27,30,-3,-3,-3
2013-04-04,3,Good,Rivera,Good,Unanimous,Colón,30,27,Tamburrino,30,27,Urso,29,28,3,3,1
2013-04-04,3,Horcher,Nover,Nover,Unanimous,Barry,27,30,Sinclair,27,30,Urso,28,29,-3,-3,-1
2013-04-04,3,Rivera,Kelleher,Rivera,Unanimous,Barry,29,28,Colón,30,27,Sinclair,29,28,1,3,1
2013-03-28,3,Zayats,Newton,Newton,Unanimous,Balas,28,29,Davis,28,29,Ross,28,29,-1,-1,-1
2013-03-28,3,Mann,Lima,Lima,Unanimous,Balas,27,30,Lee,27,30,Ross,27,30,-3,-3,-3
2013-03-28,3,Aguilar,Vidonic,Aguilar,Split,Davis,28,29,Lee,29,28,Ross,29,28,-1,1,1
2013-03-28,3,Clark,Herrig,Herrig,Split,Davis,28,29,Lee,28,29,Ross,29,28,-1,-1,1
2013-03-28,3,Cenoble,Fryklund,draw,Split,Balas,29,27,Davis,28,28,Lee,27,29,2,0,-2
2013-03-23,3,Johnson,Arlovski,Johnson,Unanimous,Krawiec,29,28,Rodriguez,29,28,Sinclair,29,28,1,1,1
2013-03-23,3,Filho,Branch,Branch,Unanimous,Bilyk,26,30,Rodriguez,27,30,Tirelli,27,30,-4,-3,-3
2013-03-23,3,Villefort,McCray,Villefort,Split,Bilyk,29,28,Rodriguez,29,28,Sinclair,28,29,1,1,-1
2013-03-23,3,Wade,Dugulubgov,Dugulubgov,Unanimous,Bilyk,27,30,Sinclair,27,30,Tirelli,27,30,-3,-3,-3
2013-03-21,3,Jansen,Held,Jansen,Unanimous,Anderson,29,28,Borssen,29,28,Ginsberg,29,28,1,1,1
2013-03-16,3,Blachowicz,Reljic,Blachowicz,Unanimous,Bonkowski,30,25,Pawlega,30,26,Rysiewski,30,27,5,4,3
2013-03-16,3,Bedorf,Thompson,Bedorf,Unanimous,Pawlega,30,26,Rysiewski,30,28,Wojciechowski,29,27,4,2,2
2013-03-16,5,St-Pierre,Diaz,St-Pierre,Unanimous,Bertrand,50,45,D'Amato,50,45,Therien,50,45,5,5,5
2013-03-16,3,Condit,Hendricks,Hendricks,Unanimous,D'Amato,28,29,Paquette,28,29,Roussel,28,29,-1,-1,-1
2013-03-16,3,Camozzi,Ring,Camozzi,Split,Bertrand,29,28,D'Amato,29,28,Roussel,28,29,1,1,-1
2013-03-16,3,Ricci,Fletcher,Ricci,Unanimous,Paquette,30,27,Roussel,30,27,Therien,30,27,3,3,3
2013-03-16,3,Voelker,Cote,Cote,Unanimous,Bertrand,28,29,D'Amato,28,29,Therien,28,29,-1,-1,-1
2013-03-16,3,Makdessi,Cruickshank,Makdessi,Unanimous,Paquette,29,28,Roussel,29,28,Therien,29,28,1,1,1
2013-03-16,3,Roop,Duran,Roop,Unanimous,D'Amato,29,28,Paquette,29,28,Roussel,30,27,1,1,3
2013-03-09,5,Grimaud,Pendred,Pendred,Unanimous,Cartlidge,46,49,Sledge,47,48,Weir,46,49,-3,-1,-3
2013-03-09,3,Marin,McVeigh,McVeigh,Unanimous,Cartlidge,27,30,Sledge,27,30,Weir,28,29,-3,-3,-1
2013-03-09,3,Hope,Kono,Hope,Split,Cartlidge,29,28,Sledge,28,29,Weir,29,28,1,-1,1
2013-03-09,3,Battell,Haque,Haque,Unanimous,Cartlidge,26,30,Sledge,28,29,Weir,27,29,-4,-1,-2
2013-03-07,3,Aliev,Marshall,Marshall,Split,Beltran,28,29,Denkin,28,29,Griffin,30,27,-1,-1,3
2013-03-07,3,Bezerra,Richman,Richman,Split,Beltran,28,29,Denkin,28,29,Griffin,29,28,-1,-1,1
2013-03-07,3,Appelt,Lara,Appelt,Unanimous,Beltran,30,24,Denkin,30,24,Griffin,30,24,6,6,6
2013-03-07,3,Smith,Miller,Miller,Unanimous,Beltran,27,30,Denkin,27,30,Griffin,27,30,-3,-3,-3
2013-03-03,3,Gomi,Sanchez,Sanchez,Split,Cartlidge,29,28,Foley,28,29,Watts,28,29,1,-1,-1
2013-03-03,3,Okami,Lombard,Okami,Split,Foley,29,28,Kamijo,29,28,Keech,28,29,1,1,-1
2013-03-03,3,Hirota,Yahya,Yahya,Unanimous,Cartlidge,28,29,Kamijo,28,29,Watts,28,29,-1,-1,-1
2013-03-03,3,Kim,Bahadurzada,Kim,Unanimous,Cartlidge,30,27,Foley,30,27,Keech,30,27,3,3,3
2013-03-03,3,Tavares,Fukuda,Tavares,Unanimous,Foley,29,28,Kamijo,29,28,Keech,30,27,1,1,3
2013-03-03,3,Mizugaki,Caraway,Mizugaki,Split,Cartlidge,28,29,Kamijo,29,28,Watts,29,28,-1,1,1
2013-03-03,3,Tokudome,Marcello,Tokudome,Unanimous,Cartlidge,30,27,Foley,30,27,Keech,30,27,3,3,3
2013-02-28,5,M'Pumbu,Vegh,Vegh,Unanimous,Espinoza,45,50,Rios,47,48,Sanchez,46,49,-5,-1,-3
2013-02-28,3,Fischer,Rickels,Rickels,Unanimous,Paez,28,29,Rios,27,30,Sanchez,27,30,-1,-3,-3
2013-02-23,3,Machida,Henderson,Machida,Split,Bell,29,28,Cleary,29,28,Peoples,28,29,1,1,-1
2013-02-23,3,McGee,Neer,McGee,Unanimous,Bell,30,27,Beltran,30,27,Vierra,30,27,3,3,3
2013-02-23,3,Johnson,Schaub,Schaub,Unanimous,Beltran,27,30,Cleary,27,30,Peoples,27,30,-3,-3,-3
2013-02-23,3,Grice,Bermudez,Bermudez,Split,Bell,28,29,Beltran,28,29,Vierra,29,28,-1,-1,1
2013-02-23,3,Stout,Fodor,Stout,Split,Beltran,29,28,Cleary,28,29,Peoples,29,28,1,-1,1
2013-02-23,3,Magny,Manley,Magny,Unanimous,Bell,29,28,Cleary,30,27,Peoples,30,27,1,3,3
2013-02-23,3,Villefort,Burrell,Burrell,Unanimous,Bell,27,30,Cleary,28,29,Vierra,28,29,-3,-1,-1
2013-02-21,3,Marx,Beebe,Marx,Unanimous,Dutcher,30,27,Furse,30,27,Mcmahon,30,27,3,3,3
2013-02-21,3,Juarez,Smith,Juarez,Split,Andrews,29,28,Calderwood,28,29,Wombacher,30,27,1,-1,3
2013-02-16,3,Swanson,Poirier,Swanson,Unanimous,Lee,29,28,Roberts,30,27,Watts,30,27,1,3,3
2013-02-16,3,Nelson,Santiago,Nelson,Unanimous,Chatfield,29,28,Lee,30,27,Roberts,29,28,1,3,1
2013-02-16,3,Te Huna,Jimmo,Te Huna,Unanimous,Lee,29,27,Roberts,29,28,Weir,29,28,2,1,1
2013-02-16,3,Forte,Etim,Forte,Unanimous,Harris,29,28,Lee,30,27,Watts,29,28,1,3,1
2013-02-16,3,Castillo,Sass,Castillo,Unanimous,Chatfield,29,28,Roberts,30,27,Weir,30,27,1,3,3
2013-02-16,3,Ogle,Grispi,Ogle,Unanimous,Lee,29,28,Roberts,29,28,Watts,30,27,1,1,3
2013-02-16,3,Lee,Tezuka,Lee,Unanimous,Harris,30,27,Lee,30,27,Roberts,30,27,3,3,3
2013-02-16,3,Gomez,Harris,Harris,Unanimous,Chatfield,27,30,Watts,27,30,Weir,28,29,-3,-3,-1
2013-02-14,3,Cramer,Rogers,Cramer,Unanimous,Elliott,29,28,Evans,29,28,Hopper Jr.,30,27,1,1,3
2013-02-14,3,Cooper,Paraisy,Cooper,Unanimous,Elliott,30,27,Evans,30,27,Hopper Jr.,30,27,3,3,3
2013-02-14,3,Parlo,Aliev,Aliev,Unanimous,Elliott,28,29,Evans,28,29,Hopper Jr.,28,29,-1,-1,-1
2013-02-14,3,Mierzwiak,Buck,Buck,Unanimous,Elliott,28,29,Evans,28,29,Hopper Jr.,28,29,-1,-1,-1
2013-02-14,3,Goodwin,Maldonado,Maldonado,Unanimous,Elliott,27,30,Evans,27,30,Hopper Jr.,28,29,-3,-3,-1
2013-02-07,3,Stepanyan,Sandro,Sandro,Majority,Cleary,27,29,Coffey,27,29,Harnist,28,28,-2,-2,0
2013-02-07,3,Crenshaw,Rogers,Rogers,Unanimous,Cleary,28,29,Harnist,28,29,Waller,28,29,-1,-1,-1
2013-02-02,5,Edgar,Aldo,Aldo,Unanimous,Byrd,46,49,Collins,47,48,Kamijo,46,49,-3,-1,-3
2013-02-02,3,Evans,Nogueira,Nogueira,Unanimous,D'Amato,28,29,Morse Jarman,28,29,Trowbridge,28,29,-1,-1,-1
2013-02-02,3,Maia,Fitch,Maia,Unanimous,Byrd,30,27,Collins,30,27,Morse Jarman,30,27,3,3,3
2013-02-02,3,Benavidez,McCall,Benavidez,Unanimous,Smith,29,28,Trowbridge,29,28,Weeks,29,28,1,1,1
2013-02-02,3,Tibau,Dunham,Dunham,Split,Collins,29,28,D'Amato,28,29,Kamijo,28,29,1,-1,-1
2013-02-02,3,Vallie-Flagg,Edwards,Vallie-Flagg,Split,Kamijo,28,29,Morse Jarman,29,28,Smith,29,28,-1,1,1
2013-01-31,3,Rickels,Woodard,Rickels,Unanimous,Anderson,29,28,Colón,29,28,Urso,29,28,1,1,1
2013-01-31,3,Brooks,Tirloni,Brooks,Unanimous,Colón,30,27,Hinds,30,27,Urso,30,27,3,3,3
2013-01-31,3,Shepherd,Reese,Reese,Unanimous,Anderson,28,29,Hinds,27,30,Urso,27,30,-1,-3,-3
2013-01-31,3,Kirk,Zelinski,Zelinski,Split,Anderson,27,30,Colón,29,28,Urso,28,29,-3,1,-1
2013-01-26,5,Johnson,Dodson,Johnson,Unanimous,D'Amato,48,47,Sabaitis,49,46,Torriero,48,47,1,3,1
2013-01-26,3,Teixeira,Jackson,Teixeira,Unanimous,D'Amato,30,27,Sabaitis,30,27,Torriero,29,28,3,3,1
2013-01-26,3,Guida,Hioki,Guida,Split,D'Amato,29,28,Sabaitis,30,27,Winter,28,29,1,3,-1
2013-01-26,3,Stumpf,Krauss,Krauss,Unanimous,D'Amato,27,30,Goodman,27,30,Puccillo,27,30,-3,-3,-3
2013-01-26,3,Thoresen,Mitchell,Mitchell,Unanimous,D'Amato,27,30,Torriero,27,30,Winter,27,30,-3,-3,-3
2013-01-24,3,Adzitso,Saunders,Saunders,Unanimous,Anderson,27,30,Mathisen,27,30,Turnage,27,30,-3,-3,-3
2013-01-24,3,Weedman,Zaromskis,Weedman,Unanimous,Anderson,29,27,Mathisen,29,27,Turnage,29,27,2,2,2
2013-01-24,3,Jones,Coleman,Coleman,Unanimous,Mathisen,28,29,Sutherland,28,29,Turnage,28,29,-1,-1,-1
2013-01-19,3,Sarafian,Dollaway,Dollaway,Split,Collett,28,29,Hughes,29,28,Lee,28,29,-1,1,-1
2013-01-19,3,Pepey,Vieira,Pepey,Split,Collett,29,28,D'Amato,29,28,Hughes,28,29,1,1,-1
2013-01-19,3,Craig,Markes,Markes,Unanimous,Bittencourt,28,29,Hughes,28,29,Lee,28,29,-1,-1,-1
2013-01-19,3,Nunes,Lentz,Lentz,Unanimous,Bittencourt,28,30,Collett,27,30,D'Amato,26,30,-2,-3,-4
2013-01-17,5,Curran,Freire,Curran,Split,Bell,48,47,Lebell,47,48,Mccarthy,48,47,1,-1,1
2013-01-17,3,Camacho,Miller,Miller,Unanimous,Bell,27,30,Griffin,27,30,Mccarthy,27,30,-3,-3,-3
2013-01-17,3,Navarro,Luciano,Luciano,Unanimous,Bell,27,30,Griffin,27,30,Mccarthy,27,30,-3,-3,-3
2013-01-12,5,Saffiedine,Marquardt,Saffiedine,Unanimous,Higdon,48,47,Lambert,49,46,Turnage,49,46,1,3,3
2013-01-12,3,Couture,Noons,Couture,Split,Atwood,29,28,Higdon,27,30,Lambert,29,28,1,-3,1
2013-01-12,3,Healy,Holobaugh,Healy,Unanimous,Lambert,30,27,Moore,30,27,Turnage,29,28,3,3,1
2013-01-12,3,Martins,Gurgel,Martins,Unanimous,Atwood,29,28,Lambert,30,27,Moore,29,28,1,3,1
2013-01-05,5,Rawlings,Esparza,Esparza,Unanimous,Boone,45,50,Clifton,45,50,Gueary,45,50,-5,-5,-5
2013-01-05,3,Smith,Pennington,Smith,Unanimous,Boone,29,28,Clifton,29,28,Gueary,29,28,1,1,1
2013-01-05,3,D'Alelio,Nunes,D'Alelio,Unanimous,Boone,30,27,Clifton,30,27,Gueary,30,27,3,3,3
2013-01-05,3,Gomes,Yamanaka,Gomes,Unanimous,Boone,30,27,Clifton,29,28,Gueary,29,28,3,1,1
2013-01-05,3,von Plettenberg,Wood,Wood,Unanimous,Boone,26,30,Clifton,27,30,Gueary,27,30,-4,-3,-3
2013-01-05,3,Brents,Bell,Brents,Unanimous,Boone,29,28,Clifton,29,28,Gueary,29,28,1,1,1
2013-01-05,3,Esquibel,McCarthy,Esquibel,Split,Boone,28,29,Clifton,30,27,Gueary,29,28,-1,3,1
2013-01-05,3,Torres,VanZant,Torres,Unanimous,Boone,30,27,Clifton,30,27,Gueary,30,27,3,3,3
2012-12-29,5,dos Santos,Velasquez,Velasquez,Unanimous,Rosales,45,50,Trowbridge,43,50,Weeks,44,50,-5,-7,-6
2012-12-29,3,Lauzon,Miller,Miller,Unanimous,Byrd,28,29,Kamijo,28,29,Morse Jarman,28,29,-1,-1,-1
2012-12-29,3,Belcher,Okami,Okami,Unanimous,Kamijo,27,30,Rosales,28,29,Weeks,27,30,-3,-1,-3
2012-12-29,3,Leben,Brunson,Brunson,Unanimous,Byrd,28,29,Morse Jarman,28,29,Smith,28,29,-1,-1,-1
2012-12-29,3,Wineland,Pickett,Wineland,Split,Smith,28,29,Trowbridge,30,27,Weeks,30,27,-1,3,3
2012-12-29,3,Guillard,Varner,Varner,Split,Byrd,30,27,Peoples,27,30,Smith,27,30,3,-3,-3
2012-12-29,3,Johnson,Jury,Jury,Unanimous,Morse Jarman,27,30,Rosales,27,30,Trowbridge,27,30,-3,-3,-3
2012-12-29,3,Garcia,Holloway,Holloway,Split,Peoples,28,29,Rosales,28,29,Smith,29,28,-1,-1,1
2012-12-15,3,Scott,Whittaker,Whittaker,Unanimous,Hickmott,28,29,Keech,28,29,Papaioannou,28,29,-1,-1,-1
2012-12-15,3,Fletcher,Parke,Parke,Unanimous,Hickmott,28,29,Hughes,27,30,Keech,27,30,-1,-3,-3
2012-12-15,3,Pierce,Baczynski,Pierce,Unanimous,Dimitriou,30,27,Hughes,29,28,Keech,29,28,3,1,1
2012-12-15,3,Loughnane,Wilkinson,Wilkinson,Unanimous,Hughes,28,29,Keech,28,29,Papaioannou,28,29,-1,-1,-1
2012-12-15,3,Smith,Ricci,Smith,Unanimous,Crosby,30,26,Silbert,30,27,Weeks,30,27,4,3,3
2012-12-15,3,Papazian,Elliott,Elliott,Unanimous,Kamijo,25,30,Silbert,25,30,Trowbridge,26,30,-5,-5,-4
2012-12-14,3,McCottrell,Muhammad,Muhammad,Unanimous,Hinkel,27,30,Morley,27,30,Torriero,27,30,-3,-3,-3
2012-12-14,5,Hale,Volkov,Volkov,Unanimous,Caldwell,46,49,Madrigal,46,49,Torriero,46,49,-3,-3,-3
2012-12-14,3,Vizcaya,Hermansson,Vizcaya,Split,Hinkel,28,29,Morley,29,28,Torriero,29,28,-1,1,1
2012-12-14,3,Vidonic,Herrig,Herrig,Unanimous,Hinkel,27,30,Madrigal,27,30,Morley,27,30,-3,-3,-3
2012-12-14,3,Wright Jr.,Uflacker,Uflacker,Unanimous,Caldwell,28,29,Hinkel,28,29,Torriero,28,29,-1,-1,-1
2012-12-14,3,Williams,Diehl,Williams,Unanimous,Madrigal,29,28,Morley,29,28,Torriero,29,28,1,1,1
2012-12-14,3,White,Booker,White,Unanimous,Hinkel,29,28,Morley,29,28,Torriero,29,28,1,1,1
2012-12-08,5,Diaz,Henderson,Henderson,Unanimous,D'Amato,45,50,Hagen,45,50,Rosales,43,50,-5,-5,-7
2012-12-08,3,Gustafsson,Rua,Gustafsson,Unanimous,D'Amato,30,27,Griffin,30,27,Hagen,30,26,3,3,4
2012-12-08,3,MacDonald,Penn,MacDonald,Unanimous,D'Amato,30,26,Griffin,30,26,Rosales,30,27,4,4,3
2012-12-08,3,Easton,Assuncao,Assuncao,Unanimous,Boehlke,28,29,Griffin,27,30,Rosales,27,30,-1,-3,-3
2012-12-08,3,Nijem,Proctor,Nijem,Unanimous,Griffin,29,28,Rosales,29,28,Roy,30,27,1,1,3
2012-12-08,3,Siver,Phan,Siver,Unanimous,Boehlke,30,24,D'Amato,30,25,Hagen,30,26,6,5,4
2012-12-07,3,Ledesma,Harris,Ledesma,Unanimous,Barry,30,27,Colflesh,30,27,Urso,30,27,3,3,3
2012-12-07,3,Lozano,Pham,Pham,Unanimous,Barry,28,29,Colflesh,28,29,Mason,28,29,-1,-1,-1
2012-12-07,3,Liguori,Horcher,Horcher,Unanimous,Barry,28,29,Colflesh,28,29,Urso,28,29,-1,-1,-1
2012-12-07,3,Makovsky,Leone,Leone,Split,Barry,29,28,Mason,28,29,Urso,28,29,1,-1,-1
2012-12-07,3,Rivera,Brock,Rivera,Unanimous,Barry,30,27,Colflesh,30,27,Mason,29,28,3,3,1
2012-12-07,3,Wessel,Kudin,Wessel,Unanimous,Barry,29,28,Mason,29,28,Urso,29,28,1,1,1
2012-12-01,12,Cotto,Trout,Trout,Unanimous,Byrd,109,119,Poturaj,111,117,Weisfeld,111,117,-10,-6,-6
2012-11-30,3,Koreshkov,Good,Koreshkov,Unanimous,Colón,29,28,Peabody,29,28,Urso,29,28,1,1,1
2012-11-30,3,Fischer,Rickels,Rickels,Unanimous,Haggith,27,30,Tirelli,28,29,Urso,28,29,-3,-1,-1
2012-11-30,3,Hervey,Sarnavskiy,Sarnavskiy,Unanimous,Haggith,27,30,Tirelli,27,30,Urso,27,30,-3,-3,-3
2012-11-30,3,Czarnecki,Houghton,Czarnecki,Unanimous,Colón,29,28,Tirelli,29,28,Urso,29,28,1,1,1
2012-11-30,3,Bunch,Coon,Bunch,Unanimous,Peabody,30,27,Tirelli,30,27,Urso,30,27,3,3,3
2012-11-17,5,Condit,St-Pierre,St-Pierre,Unanimous,D'Amato,46,49,Therien,45,50,Weeks,45,50,-3,-5,-5
2012-11-17,3,Lawlor,Carmont,Carmont,Split,D'Amato,29,28,Urso,28,29,Weeks,28,29,1,-1,-1
2012-11-17,3,Bocek,dos Anjos,dos Anjos,Unanimous,Roussel,27,30,Therien,27,30,Woodburn,27,30,-3,-3,-3
2012-11-17,3,Garza,Hominick,Garza,Unanimous,D'Amato,29,27,Urso,29,28,Weeks,30,26,2,1,4
2012-11-17,3,Stout,Makdessi,Makdessi,Unanimous,D'Amato,27,30,Roussel,28,29,Therien,27,30,-3,-1,-3
2012-11-17,3,Carvalho,Damm,Carvalho,Split,Urso,28,29,Weeks,29,28,Woodburn,29,28,-1,1,1
2012-11-17,3,Riddle,Maguire,Riddle,Unanimous,D'Amato,30,27,Roussel,29,28,Weeks,30,27,3,1,3
2012-11-17,3,Siler,Elkins,Elkins,Unanimous,D'Amato,27,30,Urso,27,30,Weeks,27,30,-3,-3,-3
2012-11-16,3,Tirloni,Jansen,Jansen,Split,Colón,29,28,Miner,28,29,Tirelli,28,29,1,-1,-1
2012-11-16,3,Filkins,Billstein,Filkins,Unanimous,Lima,29,28,Miner,29,28,Tirelli,30,27,1,1,3
2012-11-16,3,Machaev,Nelson,Machaev,Unanimous,Colón,30,27,Lima,30,27,Miner,30,27,3,3,3
2012-11-16,3,Barrow,Bessette,Bessette,Unanimous,Colón,27,30,Miner,28,29,Tirelli,27,30,-3,-1,-3
2012-11-10,3,Thiago,Kim,Kim,Unanimous,Collett,26,30,Singh,27,30,Watts,27,30,-4,-3,-3
2012-11-10,3,Danzig,Gomi,Gomi,Split,Chatfield,29,28,Collett,28,29,Watts,28,29,1,-1,-1
2012-11-10,3,Zhang,Tuck,Tuck,Unanimous,Collett,28,29,Fan,28,29,Singh,27,30,-1,-1,-3
2012-11-10,3,Hougland,Mizugaki,Mizugaki,Unanimous,Chatfield,25,30,Fan,27,30,Watts,27,30,-5,-3,-3
2012-11-10,3,Tezuka,Caceres,Caceres,Split,Chatfield,27,30,Collett,27,30,Singh,29,28,-3,-3,1
2012-11-10,3,Lineker,Urushitani,Lineker,Unanimous,Chatfield,29,28,Fan,30,27,Watts,29,28,1,3,1
2012-11-10,3,Fukuda,DeBlass,Fukuda,Unanimous,Fan,30,27,Singh,29,28,Watts,29,28,3,1,1
2012-11-09,3,Warren,Evinger,Warren,Unanimous,Gomez,30,27,Green,30,27,Warring,30,27,3,3,3
2012-11-09,3,Fabiano,Martinez,Martinez,Unanimous,Gomez,28,29,Rodriguez,27,30,Warring,28,29,-1,-3,-1
2012-11-09,3,Cobb,Cooper,Cooper,Unanimous,Green,27,30,Rodriguez,27,30,Warring,27,30,-3,-3,-3
2012-11-09,3,Alexandre,Quayhagen,Alexandre,Unanimous,Gomez,30,27,Green,30,27,Warring,30,27,3,3,3
2012-11-09,3,Slack,Moiseichik,Slack,Unanimous,Gomez,30,27,Green,30,27,Rodriguez,30,27,3,3,3
2012-11-09,3,Quinones,Girtz,Girtz,Unanimous,Gomez,28,29,Green,28,29,Rodriguez,28,29,-1,-1,-1
2012-11-03,3,Torres,Moraes,Moraes,Split,Hagen,27,30,Kamijo,29,28,Smith,28,29,-3,1,-1
2012-11-03,3,Cobb,Torres,Cobb,Split,Griffin,29,28,Hagen,29,28,Morse Jarman,28,29,1,1,-1
2012-11-03,3,Harris,Burkman,Burkman,Unanimous,Griffin,27,30,Kamijo,28,29,Morse Jarman,28,29,-3,-1,-1
2012-11-03,3,Jacoby,Branch,Branch,Unanimous,Kamijo,28,29,Morse Jarman,28,29,Smith,28,29,-1,-1,-1
2012-11-02,3,Ford,Baker,Ford,Unanimous,Buckley,29,28,Roussel,30,27,Therien,30,27,1,3,3
2012-11-02,3,Franck,Aurelio,Franck,Split,Roussel,29,28,Vandermeer,29,28,Woods,28,29,1,1,-1
2012-10-26,3,Steele,Rogers,Rogers,Unanimous,Connors,27,30,Pope,27,30,Wolfe,27,30,-3,-3,-3
2012-10-26,3,Noland,Frausto Gurgel,Frausto Gurgel,Unanimous,Connors,28,29,Schwarz,28,29,Wolfe,28,29,-1,-1,-1
2012-10-26,3,Edwards,Hanna,Hanna,Split,Pope,28,29,Schwarz,29,28,Wolfe,28,29,-1,1,-1
2012-10-19,3,Clementi,Sarnavskiy,Clementi,Split,Colflesh,29,28,Duruttya,29,28,Kao,28,29,1,1,-1
2012-10-19,3,Held,Machaev,Held,Unanimous,Colflesh,29,28,Duruttya,29,28,Kao,29,28,1,1,1
2012-10-19,3,Marrero,Polley,Polley,Unanimous,Colflesh,27,30,Duruttya,28,29,Monskie,28,29,-3,-1,-1
2012-10-19,3,Sepulveda,Bastress,Bastress,Split,Colflesh,29,28,Kao,28,29,Monskie,28,29,1,-1,-1
2012-10-13,3,Fitch,Silva,Fitch,Unanimous,Chatfield,29,28,Collett,29,28,Hughes,30,27,1,1,3
2012-10-13,3,Tibau,Trinaldo,Tibau,Unanimous,Chatfield,29,28,Collett,29,28,Hughes,29,28,1,1,1
2012-10-13,3,Gambino,Brandão,Brandão,Unanimous,Collett,27,30,Crosby,27,30,Urso,27,30,-3,-3,-3
2012-10-13,3,Camozzi,Cane,Camozzi,Unanimous,Collett,29,28,Crosby,29,28,Hughes,29,28,1,1,1
2012-10-13,3,Madadi,Marcello,Marcello,Split,Bittencourt,28,29,Chatfield,27,30,Urso,29,28,-1,-3,1
2012-10-12,3,Malegarie,Martinez,Martinez,Unanimous,Jackson,27,30,Mcneil,27,30,Roussel,27,30,-3,-3,-3
2012-10-12,3,Mokdad,Marini,Mokdad,Unanimous,Jackson,29,28,Mcneil,29,28,Roussel,29,28,1,1,1
2012-10-12,3,O'Grady,Matthews,O'Grady,Split,Jackson,29,28,Mcneil,28,29,Roussel,29,28,1,-1,1
2012-10-12,3,Robinson,Laprise,Laprise,Unanimous,Costello,27,30,Jackson,27,30,Roussel,27,30,-3,-3,-3
2012-10-06,3,Honchak,Daly,Honchak,Unanimous,Champion,30,27,Gueary,30,27,Miller-Pence,30,27,3,3,3
2012-10-06,3,LaRosa,Porto,Porto,Unanimous,Champion,27,30,Gueary,27,30,Miller-Pence,27,30,-3,-3,-3
2012-10-06,3,Waterson-Gomez,Schuckman,Waterson-Gomez,Split,Champion,29,28,Gueary,29,28,Miller-Pence,28,29,1,1,-1
2012-10-06,3,Rain,Torres,Torres,Unanimous,Champion,27,30,Gueary,27,30,Miller-Pence,27,30,-3,-3,-3
2012-10-05,3,Rogers,Volkov,Volkov,Unanimous,Gaines,27,30,Hinkel,27,30,Madrigal,27,30,-3,-3,-3
2012-10-05,3,Martinez,Lara,Martinez,Majority,Gaines,29,27,Hinkel,28,28,Malott,29,27,2,0,2
2012-10-05,3,Harris,Beebe,Beebe,Unanimous,Gaines,27,30,Hinkel,27,30,Malott,28,29,-3,-3,-1
2012-10-05,3,Hieron,Ellenberger,Ellenberger,Unanimous,Blatnick,28,29,Lee,28,29,Shiely,28,29,-1,-1,-1
2012-10-05,3,Prater,LeVesseur,LeVesseur,Split,D'Amato,28,29,Kemp,28,29,Lee,29,28,-1,-1,1
2012-10-05,3,Palaszewski,Nunes,Nunes,Unanimous,Kemp,27,30,Nielsen,28,29,Shiely,27,30,-3,-1,-3
2012-09-29,3,Sadollah,Hardy,Hardy,Unanimous,Chatfield,27,30,Collett,28,29,Watts,28,29,-3,-1,-1
2012-09-29,3,Hathaway,Maguire,Hathaway,Unanimous,Collett,30,27,Crosby,30,27,Hughes,30,27,3,3,3
2012-09-29,3,Ogle,Corassani,Corassani,Split,Chatfield,28,29,Collett,30,27,Watts,28,29,-1,3,-1
2012-09-29,3,Watson,Tavares,Tavares,Split,Crosby,29,28,Hughes,27,30,Watts,28,29,1,-3,-1
2012-09-28,3,Wallhead,Good,Good,Unanimous,Almeida,27,29,Blatnick,27,29,Urso,27,29,-2,-2,-2
2012-09-28,3,Zaromskis,Taleb,Zaromskis,Unanimous,Almeida,30,27,Blatnick,29,28,Urso,29,28,3,1,1
2012-09-28,3,Koreshkov,Smith,Koreshkov,Unanimous,Almeida,29,28,Tamburrino,29,28,Urso,29,28,1,1,1
2012-09-28,3,Ould,Holland,Ould,Unanimous,Agustin,30,27,Almeida,30,27,Urso,29,28,3,3,1
2012-09-28,3,Ledesma,Foster,Ledesma,Unanimous,Blatnick,30,27,Tamburrino,30,27,Urso,30,27,3,3,3
2012-09-22,5,Johnson,Benavidez,Johnson,Split,Bertrand,47,48,Blatnick,48,47,Crosby,49,46,-1,1,3
2012-09-22,3,Bisping,Stann,Bisping,Unanimous,Blatnick,29,28,Crosby,29,28,D'Amato,29,28,1,1,1
2012-09-22,3,Hamill,Hollett,Hamill,Unanimous,Blatnick,30,27,Crosby,29,28,D'Amato,30,27,3,1,3
2012-09-22,3,Grant,Dunham,Grant,Unanimous,Bertrand,29,28,Blatnick,29,28,Crosby,30,27,1,1,3
2012-09-22,3,Pierson,Benoist,Pierson,Unanimous,Bertrand,29,28,Blatnick,29,28,Crosby,29,28,1,1,1
2012-09-22,3,Hettes,Brimage,Brimage,Unanimous,Bertrand,28,29,Blatnick,28,29,Crosby,28,29,-1,-1,-1
2012-09-15,3,Alexander,Blachowicz,Blachowicz,Unanimous,Bonkowski,26,30,Pawlega,25,30,Wojciechowski,27,30,-4,-5,-3
2012-09-15,3,Glunder,Rozalski,Rozalski,Unanimous,Bonkowski,26,30,Pawlega,26,30,Wojciechowski,26,30,-4,-4,-4
2012-09-15,3,Bedorf,Knothe,Bedorf,Unanimous,Bonkowski,30,27,Pawlega,30,26,Wojciechowski,30,26,3,4,4
2012-09-15,3,Mankowski,Moks,Mankowski,Split,Bonkowski,30,28,Pawlega,28,30,Porebski,30,28,2,-2,2
2012-09-15,3,Reed,Azhiev,Azhiev,Unanimous,Pawlega,26,30,Porebski,27,30,Wojciechowski,26,30,-4,-3,-4
2012-08-24,3,Martinez,Wessel,Wessel,Split,Ferguson,28,29,Herzog,28,29,King,30,27,-1,-1,3
2012-08-24,3,Uhrich,Williams,Uhrich,Unanimous,Ferguson,29,28,Herzog,29,28,King,30,27,1,1,3
2012-08-18,3,Saffiedine,Bowling,Saffiedine,Unanimous,Denkin,30,27,Landless,30,27,Newburg,30,27,3,3,3
2012-08-18,3,de Randamie,Yamanaka,de Randamie,Unanimous,Denkin,30,27,Griffin,30,27,Rochin,30,27,3,3,3
2012-08-18,3,Ricehouse,Green,Green,Unanimous,Landless,27,30,Newburg,27,30,Rochin,27,30,-3,-3,-3
2012-08-11,5,Henderson,Edgar,Henderson,Split,Hagen,48,47,Van Tine,48,47,Weeks,46,49,1,1,-3
2012-08-11,3,Camus,Pague,Camus,Unanimous,Hagen,29,28,Heinz,29,28,Van Tine,30,27,1,1,3
2012-08-04,3,Phan,Miller,Phan,Split,Beltran,29,28,Griffin,28,29,Peoples,29,28,1,-1,1
2012-08-04,3,Gamburyan,Omigawa,Gamburyan,Unanimous,Beltran,29,28,Griffin,29,28,Peoples,30,27,1,1,3
2012-07-28,3,McMann,Baszler,McMann,Unanimous,Clifton,29,28,Gueary,30,27,Miller-Pence,29,28,1,3,1
2012-07-28,3,Chavez,Rivera-Calanoc,Rivera-Calanoc,Unanimous,Clifton,27,30,Gueary,28,29,Miller-Pence,28,29,-3,-1,-1
2012-07-28,3,Pennington,Moras,Pennington,Unanimous,Clifton,30,27,Gueary,29,28,Miller-Pence,29,28,3,1,1
2012-07-28,3,Jones-Lybarger,Chan,Jones-Lybarger,Unanimous,Clifton,29,28,Gueary,29,28,Miller-Pence,29,28,1,1,1
2012-07-21,5,Barão,Faber,Barão,Unanimous,Blatnick,49,46,D'Amato,49,46,Lee,50,45,3,3,5
2012-07-21,3,Boetsch,Lombard,Boetsch,Split,Bertrand,28,29,D'Amato,29,28,Lee,29,28,-1,1,1
2012-07-21,3,Kongo,Jordan,Kongo,Unanimous,Adamcik,30,27,Bertrand,30,27,Blatnick,30,28,3,3,2
2012-07-21,3,Head,Ebersole,Head,Split,Blatnick,29,28,D'Amato,28,29,Lee,29,28,1,-1,1
2012-07-21,3,McGee,Ring,Ring,Unanimous,Adamcik,28,29,Bertrand,28,29,Lee,28,29,-1,-1,-1
2012-07-21,3,Kuivanen,Clarke,Kuivanen,Split,Bertrand,29,28,Blatnick,29,28,D'Amato,28,29,1,1,-1
2012-07-17,3,Newton,Vegh,Vegh,Split,Davis,28,29,Ross,28,29,Torres,30,27,-1,-1,3
2012-07-17,3,Wiuff,Carpenter,Wiuff,Unanimous,Balas,30,27,Ross,30,27,Torres,30,27,3,3,3
2012-07-17,3,Spiritwolf,Zaromskis,Zaromskis,Split,Balas,29,28,Davis,27,30,Ross,28,29,1,-3,-1
2012-07-17,3,Slack,McCook,McCook,Split,Balas,28,29,Davis,28,29,Torres,29,28,-1,-1,1
2012-07-14,5,Kennedy,Rockhold,Rockhold,Unanimous,Hamilton,46,49,Kamijo,46,49,Trowbridge,46,49,-3,-3,-3
2012-07-14,3,Gracie,Jardine,Gracie,Unanimous,Barringer,29,27,Dinger,30,27,Hamilton,30,26,2,3,4
2012-07-14,3,Lawler,Larkin,Larkin,Unanimous,Barringer,27,30,Dinger,27,30,Hamilton,27,30,-3,-3,-3
2012-07-14,3,Healy,Hirota,Healy,Unanimous,Barringer,29,28,Dinger,30,27,Kamijo,29,28,1,3,1
2012-07-14,3,Couture,Duarte,Couture,Split,Barringer,28,29,Dinger,29,28,Hamilton,29,28,-1,1,1
2012-07-14,3,Wilcox,Masvidal,Masvidal,Split,Barringer,29,28,Gregory,27,30,Trowbridge,28,29,1,-3,-1
2012-07-14,3,Mein,Stinson,Mein,Unanimous,Dinger,30,27,Gregory,30,27,Kamijo,30,27,3,3,3
2012-07-11,3,Te Huna,Beltran,Te Huna,Unanimous,Balewicz,30,27,Morrow,30,26,Thomas-Gitlin,30,27,3,4,3
2012-07-11,3,Robertson,Simpson,Simpson,Unanimous,Balewicz,28,29,Morrow,27,30,Stell,28,29,-1,-3,-1
2012-07-11,3,Njokuani,dos Anjos,dos Anjos,Unanimous,Balewicz,27,30,Morrow,28,29,Thomas-Gitlin,27,30,-3,-1,-3
2012-07-11,3,Cariaso,Ferguson,Cariaso,Unanimous,Balewicz,30,27,Stell,30,27,Thomas-Gitlin,30,27,3,3,3
2012-07-11,3,Guimaraes,Stittgen,Guimaraes,Split,Balewicz,29,28,Morrow,28,29,Thomas-Gitlin,29,28,1,-1,1
2012-07-07,3,Ortiz,Griffin,Griffin,Unanimous,Byrd,28,29,Collins,28,29,Weeks,28,29,-1,-1,-1
2012-07-07,3,Le,Cote,Le,Unanimous,Kamijo,30,27,Smith,30,27,Trowbridge,30,27,3,3,3
2012-07-07,3,Menjivar,Easton,Easton,Unanimous,Kamijo,28,29,Lee,27,30,Smith,27,30,-1,-3,-3
2012-07-07,3,Guillard,Camões,Guillard,Unanimous,Byrd,30,27,Morse Jarman,30,27,Weeks,30,27,3,3,3
2012-07-07,3,Nurmagomedov,Tibau,Nurmagomedov,Unanimous,Collins,30,27,Smith,30,27,Trowbridge,30,27,3,3,3
2012-07-07,3,Fukuda,Philippou,Philippou,Unanimous,Collins,27,30,Lee,27,30,Weeks,28,29,-3,-3,-1
2012-07-07,3,Roller,Alessio,Roller,Unanimous,Byrd,29,28,Morse Jarman,29,28,Trowbridge,29,28,1,1,1
2012-07-07,3,Izquierdo,Oliveira,Oliveira,Unanimous,Kamijo,28,29,Smith,28,29,Weeks,28,29,-1,-1,-1
2012-06-23,5,Silva,Franklin,Franklin,Unanimous,Collett,46,49,Hughes,46,49,Watts,46,49,-3,-3,-3
2012-06-23,3,Moraes,Ferreira,Ferreira,Unanimous,Chatfield,28,29,Collett,27,30,Winter,27,30,-1,-3,-3
2012-06-23,3,Jason,Pepey,Jason,Unanimous,Chatfield,29,28,Hughes,29,28,Winter,29,28,1,1,1
2012-06-23,3,Alcântara,Dias,Dias,Unanimous,Collett,28,29,Hughes,27,30,Watts,27,30,-1,-3,-3
2012-06-23,3,Viana,Macapa,Viana,Split,Collett,29,28,Hughes,29,28,Winter,28,29,1,1,-1
2012-06-23,3,Arantes,Vieira,draw,Split,Chatfield,28,28,Hughes,28,29,Watts,29,28,0,-1,1
2012-06-22,3,Goldbaugh,Zalac,Zalac,Unanimous,Kruszka,28,29,Samples,28,29,Snider,28,29,-1,-1,-1
2012-06-22,5,Maynard,Guida,Maynard,Split,Colón,48,47,Sanidad,48,47,Tabora,47,48,1,1,-1
2012-06-22,3,Fisher,Stout,Stout,Unanimous,Agustin,27,30,Bilyk,27,30,Sinclair,27,30,-3,-3,-3
2012-06-22,3,Ebersole,Waldburger,Ebersole,Unanimous,Bilyk,29,28,Sinclair,29,28,Tabora,29,28,1,1,1
2012-06-22,3,Lamas,Hioki,Lamas,Unanimous,Agustin,29,28,Colón,29,28,Sanidad,29,28,1,1,1
2012-06-22,3,Jardine,Story,Story,Unanimous,Krawiec,27,30,Rodriguez,27,30,Tabora,27,30,-3,-3,-3
2012-06-22,3,Stone,Pague,Stone,Split,Bilyk,29,28,Krawiec,29,28,Rodriguez,28,29,1,1,-1
2012-06-09,12,Pacquiao,Bradley,Bradley,Split,Ford,113,115,Ross,113,115,Roth,115,113,-2,-2,2
2012-06-08,3,Johnson,McCall,Johnson,Unanimous,Gomez,29,28,Lee,30,27,Luxenberg,29,28,1,3,1
2012-06-08,3,Pierce,Rocha,Pierce,Unanimous,Bays,30,27,Davis,30,27,Lee,30,27,3,3,3
2012-06-08,3,Baczynski,Benoist,Baczynski,Split,Gomez,29,28,Green,29,28,Luxenberg,27,30,1,1,-3
2012-06-08,3,Grice,Garcia,Grice,Unanimous,Bays,30,27,Davis,30,27,Lee,30,27,3,3,3
2012-06-08,3,Roberts,Magalhães,Roberts,Unanimous,Gomez,30,27,Green,30,27,Luxenberg,29,28,3,3,1
2012-06-08,3,Martinez,Magalhães,Martinez,Split,Bays,28,29,Davis,29,28,Lee,30,27,-1,1,3
2012-06-08,3,Pierson,Hecht,Pierson,Unanimous,Gomez,29,28,Green,29,28,Luxenberg,29,28,1,1,1
2012-06-01,3,Schilling,Holloway,Holloway,Unanimous,Lee,27,30,Morse Jarman,27,30,Rosales,27,30,-3,-3,-3
2012-06-01,3,Cruickshank,Tickle,Cruickshank,Unanimous,D'Amato,29,27,Morse Jarman,29,27,Smith,29,27,2,2,2
2012-05-26,3,Elkins,Brandão,Elkins,Unanimous,Smith,29,28,Trowbridge,29,28,Weeks,29,28,1,1,1
2012-05-26,3,Miller,Dollaway,Dollaway,Unanimous,Griffin,26,30,Hagen,28,29,Smith,28,29,-4,-1,-1
2012-05-26,3,Pineda,Brown,Brown,Unanimous,Byrd,28,29,Griffin,28,29,Kamijo,28,29,-1,-1,-1
2012-05-25,3,Hawn,Weedman,Hawn,Unanimous,Barahona,29,28,Bass,30,27,Sherman,30,27,1,3,3
2012-05-25,3,Dufour,Arcement,Arcement,Unanimous,Barahona,28,29,Bass,27,30,Sherman,27,30,-1,-3,-3
2012-05-19,5,Cormier,Barnett,Cormier,Unanimous,Belardo,50,45,Morrow,49,46,Thomas-Gitlin,50,45,5,3,5
2012-05-19,5,Melendez,Thomson,Melendez,Split,Mcknight,48,47,Rasmussen,48,47,Thomas-Gitlin,47,48,1,1,-1
2012-05-19,3,Vallie-Flagg,Cavalcante,Vallie-Flagg,Split,Belardo,29,28,Mcknight,29,28,Rasmussen,28,29,1,1,-1
2012-05-19,3,Zwicker,Inocente,Inocente,Unanimous,Belardo,28,29,Morrow,28,29,Thomas-Gitlin,27,30,-1,-1,-3
2012-05-19,3,Villante,Mehmen,Villante,Unanimous,Mcknight,30,27,Rasmussen,29,28,Thomas-Gitlin,30,27,3,1,3
2012-05-19,3,Mulhern,Villefort,Mulhern,Split,Belardo,29,28,Mcknight,28,29,Morrow,30,27,1,-1,3
2012-05-19,3,Green,Terry,Green,Split,Morrow,29,28,Rasmussen,28,29,Thomas-Gitlin,29,28,1,-1,1
2012-05-18,3,Wright Jr.,Quayhagen,Quayhagen,Unanimous,Bass,27,30,Manuel,27,30,Singletary,27,30,-3,-3,-3
2012-05-18,3,Spang,FalcÃ£o,FalcÃ£o,Unanimous,Bass,27,29,Gaudet,27,29,Singletary,27,29,-2,-2,-2
2012-05-18,3,Amoussou,Rickels,Amoussou,Split,Bass,29,28,Gaudet,29,28,Singletary,28,29,1,1,-1
2012-05-18,3,Aguilar,Fujii,Aguilar,Unanimous,Bass,29,28,Gaudet,29,28,Singletary,29,28,1,1,1
2012-05-18,3,Slack,Arthur,Slack,Unanimous,Gaudet,30,27,Manuel,30,27,Singletary,30,27,3,3,3
2012-05-15,3,Sadollah,Lopez,Sadollah,Split,Blatnick,28,29,D'Amato,29,28,Urso,29,28,-1,1,1
2012-05-15,3,Stephens,Cerrone,Cerrone,Unanimous,Blatnick,27,30,D'Amato,27,30,Urso,27,30,-3,-3,-3
2012-05-15,3,Jabouin,Hougland,Jabouin,Unanimous,Blatnick,30,26,Costello,30,27,Urso,30,27,4,3,3
2012-05-15,3,Pokrajac,Maldonado,Pokrajac,Unanimous,Blatnick,29,28,Colón,29,28,D'Amato,30,27,1,1,3
2012-05-15,3,Tavares,Yang,Tavares,Unanimous,Colón,29,28,Costello,29,28,D'Amato,29,28,1,1,1
2012-05-15,3,Prater,Grant,Grant,Unanimous,Costello,27,30,D'Amato,27,30,Urso,27,30,-3,-3,-3
2012-05-15,3,Eduardo,Curran,Eduardo,Unanimous,Blatnick,29,28,Colón,29,28,Costello,29,28,1,1,1
2012-05-15,3,Soto,Rivera,Rivera,Unanimous,Colón,27,30,Costello,27,30,D'Amato,27,30,-3,-3,-3
2012-05-12,3,Materla,Silva,Materla,Majority,Bonkowski,30,28,Pawlega,29,28,Rysiewski,29,29,2,1,0
2012-05-11,3,Straus,Sandro,Straus,Unanimous,Agustin,29,28,Colón,30,27,Sanidad,30,27,1,3,3
2012-05-11,3,Marx,Galvão,Galvão,Unanimous,Agustin,28,29,Colón,28,29,Sanidad,28,29,-1,-1,-1
2012-05-11,3,Carlo-Clauss,Kirwan,Carlo-Clauss,Split,Krawiec,28,29,Rodriguez,29,28,Urso,29,28,-1,1,1
2012-05-11,3,Leone,Ledesma,Leone,Split,Colón,30,27,Sanidad,30,27,Urso,28,29,3,3,-1
2012-05-11,3,Ambang,Milliard,Ambang,Split,Krawiec,28,29,Rodriguez,29,28,Urso,29,28,-1,1,1
2012-05-05,12,Cotto,Mayweather,Mayweather,Unanimous,Hoyle,110,118,Moretti,111,117,Morse Jarman,111,117,-8,-6,-6
2012-05-05,3,Koscheck,Hendricks,Hendricks,Split,Almeida,29,28,Blatnick,28,29,Urso,28,29,1,-1,-1
2012-05-05,3,Ferguson,Johnson,Johnson,Unanimous,Almeida,27,30,Blatnick,27,30,Urso,27,30,-3,-3,-3
2012-05-05,3,Dodson,Elliott,Dodson,Unanimous,Almeida,29,28,Tamburrino,29,28,Tirelli,29,28,1,1,1
2012-05-05,3,Hathaway,Krauss,Hathaway,Unanimous,Almeida,30,27,Bittencourt,29,28,Tirelli,30,27,3,1,3
2012-05-05,3,Cholish,Castillo,Castillo,Unanimous,Blatnick,27,30,Depasquale Jr.,27,30,Tirelli,27,30,-3,-3,-3
2012-05-05,3,Garza,Bermudez,Bermudez,Unanimous,Bittencourt,27,30,Tamburrino,27,30,Urso,27,30,-3,-3,-3
2012-05-04,3,Harris,Kirk,Harris,Unanimous,Buckley,29,28,Mcneil,29,28,Therien,29,28,1,1,1
2012-05-04,3,Saunders,Baker,Baker,Unanimous,Rodgers,28,29,Roussel,27,30,Therien,27,30,-1,-3,-3
2012-05-04,3,Huckaba,Grabowski,Grabowski,Unanimous,Rodgers,28,29,Roussel,28,29,Therien,28,29,-1,-1,-1
2012-05-04,3,Nelson,Alexandre,Alexandre,Unanimous,Haggith,27,30,Roussel,27,30,Therien,27,30,-3,-3,-3
2012-04-28,3,Coenen,Ruyssen,Coenen,Unanimous,Champion,30,26,Gueary,30,26,Miller-Pence,30,26,4,4,4
2012-04-28,3,Maloy,Gutierrez,Maloy,Unanimous,Champion,29,28,Gueary,29,28,Miller-Pence,30,27,1,1,3
2012-04-28,3,Bagherdai,Cummins,Cummins,Unanimous,Champion,27,30,Gueary,28,29,Miller-Pence,27,30,-3,-1,-3
2012-04-28,3,Young,Smith,draw,Split,Champion,28,29,Gueary,29,28,Miller-Pence,29,29,-1,1,0
2012-04-21,5,Evans,Jones,Jones,Unanimous,Bertrand,45,50,Cleary,46,49,Lee,46,49,-5,-3,-3
2012-04-21,3,Hominick,Yagin,Yagin,Split,Lee,28,29,Maness,28,29,Urso,29,28,-1,-1,1
2012-04-21,3,Alessio,Bocek,Bocek,Unanimous,Bertrand,27,30,Coffey,27,30,Urso,28,29,-3,-3,-1
2012-04-21,3,Brown,Thompson,Brown,Unanimous,Cleary,30,27,Lee,30,26,Urso,29,28,3,4,1
2012-04-21,3,Njokuani,Makdessi,Njokuani,Unanimous,Bertrand,30,27,Cleary,30,27,Maness,30,27,3,3,3
2012-04-21,3,Escudero,Danzig,Danzig,Unanimous,Coffey,27,30,Lee,27,30,Urso,28,29,-3,-3,-1
2012-04-21,3,Clements,Wisniewski,Clements,Split,Cleary,29,28,Coffey,28,29,Urso,30,27,1,-1,3
2012-04-21,3,Blanco,Brimage,Brimage,Split,Bertrand,27,30,Lee,28,29,Maness,29,28,-3,-1,1
2012-04-20,3,Eye,Rodriguez,Eye,Unanimous,Armstrong,30,27,Atkins Jr.,30,27,Rogers,30,27,3,3,3
2012-04-20,3,Vasilevsky,FalcÃ£o,FalcÃ£o,Unanimous,Armstrong,28,29,Atkins Jr.,28,29,Rogers,28,29,-1,-1,-1
2012-04-20,3,Weedman,Michel,Weedman,Split,Armstrong,29,28,Moss,28,29,Rogers,29,28,1,-1,1
2012-04-20,3,Hawk,Vanttinen,Hawk,Split,Armstrong,29,28,Atkins Jr.,27,30,Moss,29,28,1,-3,1
2012-04-20,3,Spohn,Vegh,Vegh,Split,Armstrong,27,30,Atkins Jr.,29,28,Moss,28,29,-3,1,-1
2012-04-14,3,Gustafsson,Silva,Gustafsson,Unanimous,Collett,29,28,Hughes,30,27,Watts,30,27,1,3,3
2012-04-14,3,Nunes,Siver,Siver,Unanimous,Collett,28,29,Larsson,28,29,Watts,28,29,-1,-1,-1
2012-04-14,3,Diabaté,DeBlass,Diabaté,Majority,Bergman,29,28,Collett,29,28,Hughes,28,28,1,1,0
2012-04-14,3,Wisely,Young,Young,Unanimous,Ersson,28,30,Hughes,28,29,Watts,28,29,-2,-1,-1
2012-04-13,3,Straus,Corey,Straus,Unanimous,Colón,29,28,Depasquale Jr.,29,28,Tirelli,30,27,1,1,3
2012-04-13,3,Vila,Nogueira,Nogueira,Unanimous,Colón,28,29,Sanidad,28,29,Tirelli,28,29,-1,-1,-1
2012-04-13,3,Galvão,West,Galvão,Unanimous,Colón,30,27,Sanidad,30,27,Tirelli,30,27,3,3,3
2012-04-13,3,Barbosa,McCray,McCray,Split,Bilyk,28,29,Colón,29,28,Sanidad,28,29,-1,1,-1
2012-04-13,3,Malyutin,Brooks,Brooks,Unanimous,Colón,27,30,Depasquale Jr.,28,29,Tirelli,27,30,-3,-1,-3
2012-04-06,5,Askren,Lima,Askren,Unanimous,Jackson,50,45,Rodgers,50,45,Therien,50,45,5,5,5
2012-04-06,3,Bezerra,Sandro,Sandro,Split,Jackson,28,29,Rodgers,29,28,Therien,28,29,-1,1,-1
2012-04-06,3,Ueda,Marx,Marx,Unanimous,Jackson,28,29,Rodgers,28,29,Therien,28,29,-1,-1,-1
2012-04-06,3,Nakamura,Lima,Nakamura,Unanimous,Jackson,29,27,Rodgers,29,27,Therien,29,27,2,2,2
2012-04-06,3,Taleb,Secor,Taleb,Unanimous,Haggith,30,27,Mcneil,30,27,Porlier,30,24,3,3,6
2012-03-30,3,Quinn,Stevens,Quinn,Unanimous,Blatnick,29,28,Colón,29,28,Urso,30,27,1,1,3
2012-03-30,3,Bessette,Almeida,Bessette,Unanimous,Blatnick,29,28,Tirelli,30,27,Urso,30,27,1,3,3
2012-03-30,3,Baker,Pereira,Baker,Split,Blatnick,29,28,Colón,29,28,Urso,28,29,1,1,-1
2012-03-30,3,Amaya,Saunders,Saunders,Unanimous,Blatnick,26,30,Colón,27,30,Tirelli,27,30,-4,-3,-3
2012-03-30,3,Cramer,Nader,Cramer,Split,Colón,29,28,Tirelli,27,30,Urso,29,28,1,-3,1
2012-03-23,3,Peterson,Jones,Jones,Split,Armstrong,30,27,Drake-Browning,28,29,Wess,28,29,3,-1,-1
2012-03-23,3,Michel,Nazare,Michel,Split,Armstrong,29,28,Drake-Browning,28,29,Wess,29,28,1,-1,1
2012-03-23,3,Kirwan,Jansen,Jansen,Unanimous,Armstrong,28,29,Drake-Browning,28,29,Wess,27,30,-1,-1,-3
2012-03-16,3,Taylor,Quayhagen,Quayhagen,Unanimous,Cox,27,30,Gaudet,27,30,Hicks,27,30,-3,-3,-3
2012-03-16,3,Paraisy,FalcÃ£o,FalcÃ£o,Unanimous,Bass,27,30,Caskey,27,30,Gaudet,27,30,-3,-3,-3
2012-03-16,3,Vasilevsky,O'Donnell,Vasilevsky,Unanimous,Bass,29,28,Caskey,29,28,Gaudet,29,28,1,1,1
2012-03-16,3,Santana,Santos,Santos,Unanimous,Bass,27,30,Caskey,28,29,Gaudet,28,29,-3,-1,-1
2012-03-09,3,Gomez,Wiuff,Wiuff,Unanimous,Caldwell,28,29,D'Amato,28,29,Hinkel,28,29,-1,-1,-1
2012-03-09,3,Straus,Spoon,Straus,Unanimous,D'Amato,29,28,Hinkel,29,28,Madrigal,30,27,1,1,3
2012-03-09,3,Mann,Corey,Corey,Unanimous,D'Amato,28,29,Hinkel,28,29,Morley,28,29,-1,-1,-1
2012-03-09,3,Shockley,Bailey,Shockley,Unanimous,Hinkel,30,27,Madrigal,29,28,Morley,30,27,3,1,3
2012-03-03,3,Philippou,McGee,Philippou,Unanimous,D'Amato,29,28,Dimitriou,29,28,Hughes,29,28,1,1,1
2012-03-03,3,Siler,Miller,Siler,Unanimous,D'Amato,29,28,Keech,29,28,Papaioannou,29,28,1,1,1
2012-03-03,3,Noke,Craig,Craig,Unanimous,D'Amato,28,29,Hughes,28,29,Watts,28,29,-1,-1,-1
2012-03-03,3,Thomson,Noons,Thomson,Unanimous,Floor,29,28,Lee,29,28,Torriero,29,28,1,1,1
2012-03-03,3,Misaki,Daley,Misaki,Split,Floor,28,29,Torriero,29,28,Wise,30,27,-1,1,3
2012-03-03,3,Kaufman,Davis,Kaufman,Majority,Torriero,29,28,Urso,29,29,Wise,29,28,1,0,1
2012-03-03,3,McCall,Johnson,draw,Majority,D'Amato,28,28,Dimitriou,29,29,Papaioannou,28,29,0,0,-1
2012-02-26,5,Edgar,Henderson,Henderson,Unanimous,D'Amato,46,49,Hughes,47,48,Lee,46,49,-3,-1,-3
2012-02-26,3,Bader,Jackson,Bader,Unanimous,D'Amato,30,27,Kamijo,30,27,Watts,30,27,3,3,3
2012-02-26,3,Akiyama,Shields,Shields,Unanimous,Hughes,27,30,Kamijo,27,30,Watts,27,30,-3,-3,-3
2012-02-26,3,Hioki,Palaszewski,Hioki,Unanimous,D'Amato,29,28,Lee,30,27,Watts,29,28,1,3,1
2012-02-26,3,Cantwell,Fukuda,Fukuda,Unanimous,Hughes,27,30,Kamijo,27,30,Lee,28,29,-3,-3,-1
2012-02-26,3,Cariaso,Mizugaki,Cariaso,Unanimous,Hughes,29,28,Lee,29,28,Watts,29,28,1,1,1
2012-02-25,3,Blachowicz,Miranda,Blachowicz,Unanimous,Bonkowski,30,28,Pawlega,30,28,Rysiewski,30,28,2,2,2
2012-02-15,3,Ellenberger,Sanchez,Ellenberger,Unanimous,Blatnick,29,28,D'Amato,29,28,Trowbridge,29,28,1,1,1
2012-02-15,3,Simpson,Markes,Markes,Unanimous,D'Amato,29,28,Garrean,28,29,Trowbridge,28,29,1,-1,-1
2012-02-15,3,Watson,Dillashaw,Dillashaw,Unanimous,Blatnick,26,30,D'Amato,25,30,Jobeun,25,30,-4,-5,-5
2012-02-15,3,Salas,Kuivanen,Salas,Unanimous,D'Amato,30,27,Garrean,30,27,Trowbridge,29,28,3,3,1
2012-02-15,3,Magalhães,Means,Means,Unanimous,D'Amato,27,30,Graybill,26,30,Trowbridge,26,30,-3,-4,-4
2012-02-04,5,Diaz,Condit,Condit,Unanimous,Kamijo,47,48,Morse Jarman,46,49,Peoples,46,49,-1,-3,-3
2012-02-04,3,Nelson,Werdum,Werdum,Unanimous,Byrd,27,30,Lee,27,30,Trowbridge,27,30,-3,-3,-3
2012-02-04,3,Koscheck,Pierce,Koscheck,Split,Collins,29,28,D'Amato,29,28,Kamijo,28,29,1,1,-1
2012-02-04,3,Barão,Jorgensen,Barão,Unanimous,Morse Jarman,30,27,Peoples,30,27,Trowbridge,30,27,3,3,3
2012-02-04,3,Caceres,Figueroa,Figueroa,Split,D'Amato,27,28,Lee,28,27,Trowbridge,27,28,-1,1,-1
2012-02-04,3,Riddle,Martinez,Riddle,Split,Kamijo,29,28,Lee,29,28,Peoples,28,29,1,1,-1
2012-02-04,3,Natal,Kuiper,Natal,Unanimous,Byrd,30,27,D'Amato,30,27,Morse Jarman,29,28,3,3,1
2012-01-28,5,Davis,Evans,Evans,Unanimous,D'Amato,45,50,Morley,45,50,Sabaitis,45,50,-5,-5,-5
2012-01-28,3,Bisping,Sonnen,Sonnen,Unanimous,Goodman,27,30,Odum,28,29,Torriero,28,29,-3,-1,-1
2012-01-28,3,Maia,Weidman,Weidman,Unanimous,D'Amato,28,29,Morley,27,30,Sabaitis,28,29,-1,-3,-1
2012-01-28,3,Einemo,Russow,Russow,Unanimous,Goodman,28,29,Odum,27,30,Torriero,28,29,-1,-3,-1
2012-01-28,3,Johnson,Roller,Johnson,Unanimous,D'Amato,29,28,Morley,29,28,Sabaitis,29,28,1,1,1
2012-01-20,3,Papazian,Easton,Easton,Majority,Blatnick,29,29,D'Amato,27,30,Lee,28,29,0,-3,-1
2012-01-20,3,Brenneman,Roberts,Brenneman,Unanimous,Blatnick,30,27,Crosby,30,27,Lee,29,28,3,3,1
2012-01-14,3,Stout,Tavares,Tavares,Unanimous,Hughes,28,29,Rosales,27,30,Watts,28,29,-1,-3,-1
2012-01-14,3,Alcântara,Omigawa,Alcântara,Unanimous,Collett,30,27,Hughes,30,27,Watts,29,28,3,3,1
2012-01-14,3,Carvalho,Arantes,Arantes,Unanimous,Collett,28,29,Hughes,28,29,Rosales,28,29,-1,-1,-1
2012-01-07,3,Mein,Woodley,Woodley,Split,Rosales,27,30,Trowbridge,29,28,Weeks,28,29,-3,1,-1
2012-01-07,3,Saffiedine,Stinson,Saffiedine,Split,Byrd,30,27,Griffin,28,29,Morse Jarman,29,28,3,-1,1
2012-01-07,3,Terry,Burrell,Burrell,Split,Kamijo,29,28,Rosales,28,29,Trowbridge,28,29,1,-1,-1
2012-01-07,3,Spang,Legere,Legere,Unanimous,Kamijo,28,29,Morse Jarman,28,29,Weeks,28,29,-1,-1,-1
2012-01-07,3,Payan,Martinez,Payan,Unanimous,Griffin,30,27,Rosales,30,27,Trowbridge,30,27,3,3,3
2011-12-30,3,Diaz,Cerrone,Diaz,Unanimous,Byrd,30,27,Kamijo,30,27,Weeks,29,28,3,3,1
2011-12-30,3,Phan,Hettes,Hettes,Unanimous,D'Amato,25,30,Kamijo,25,30,Smith,26,30,-5,-5,-4
2011-12-30,3,Assunção,Pearson,Pearson,Unanimous,Byrd,28,29,Kamijo,28,29,Trowbridge,27,30,-1,-1,-3
2011-12-30,3,Castillo,Njokuani,Castillo,Split,Crosby,29,28,Morse Jarman,28,29,Smith,29,28,1,-1,1
2011-12-30,3,Kim,Pierson,Kim,Unanimous,Byrd,30,27,D'Amato,30,27,Weeks,30,27,3,3,3
2011-12-30,3,Escudero,Volkmann,Volkmann,Unanimous,Smith,28,29,Trowbridge,28,29,Weeks,28,29,-1,-1,-1
2011-12-30,3,Nunes,Gamburyan,Nunes,Unanimous,Crosby,29,28,D'Amato,29,28,Kamijo,29,28,1,1,1
2011-12-17,5,Masvidal,Melendez,Melendez,Unanimous,Lebell,45,50,Mccarthy,46,49,Peoples,45,50,-5,-3,-5
2011-12-17,3,Mousasi,Saint Preux,Mousasi,Unanimous,Griffin,29,28,Lebell,29,28,Mccarthy,29,28,1,1,1
2011-12-17,3,Noons,Evangelista,Noons,Unanimous,Griffin,29,28,Lebell,29,28,Peoples,29,28,1,1,1
2011-12-17,3,Salinas-Jones,Cole,Cole,Unanimous,Griffin,27,30,Lebell,27,30,Peoples,27,30,-3,-3,-3
2011-12-17,3,Mendez,Gonzalez,Mendez,Split,Griffin,28,29,Lebell,30,27,Mccarthy,29,28,-1,3,1
2011-12-10,3,Patrick,Ebersole,Ebersole,Split,Bertrand,28,29,D'Amato,28,29,Hamilton,29,28,-1,-1,1
2011-12-10,3,Watson,Jabouin,Jabouin,Split,Hamilton,27,30,Jackson,29,28,Therien,28,29,-3,1,-1
2011-12-10,3,Bocek,Lentz,Bocek,Unanimous,Hamilton,30,27,Jackson,30,27,Therien,30,27,3,3,3
2011-12-03,3,Edwards,Ferguson,Ferguson,Unanimous,Kamijo,28,29,Smith,27,30,Weeks,27,30,-1,-3,-3
2011-12-03,3,Bass,Brimage,Brimage,Unanimous,Byrd,27,30,Kamijo,28,29,Weeks,27,30,-3,-1,-3
2011-12-03,3,Siler,Clopton,Siler,Unanimous,Byrd,29,28,Collins,29,28,Weeks,29,28,1,1,1
2011-11-26,3,Dantas,Vila,Dantas,Unanimous,Agustin,29,28,Almeida,29,28,Tirelli,29,28,1,1,1
2011-11-26,3,Held,Nover,Held,Split,Agustin,29,28,Bittencourt,29,28,Colón,28,29,1,1,-1
2011-11-26,3,Maynard,Wing,Maynard,Unanimous,Bittencourt,30,27,Blatnick,30,26,Urso,30,27,3,4,3
2011-11-26,3,Milliard,Saling,Milliard,Unanimous,Agustin,30,27,Tirelli,30,27,Urso,30,27,3,3,3
2011-11-19,3,Ellis,Aguilar,Aguilar,Unanimous,Lee,27,30,Luxenberg,27,30,Rodriguez,27,30,-3,-3,-3
2011-11-19,3,Cooper,Hess,Cooper,Unanimous,Gomez,29,28,Luxenberg,29,28,Rodriguez,29,28,1,1,1
2011-11-19,3,Barbosa,Araujo,Araujo,Unanimous,Gomez,28,29,Luxenberg,28,29,Rodriguez,28,29,-1,-1,-1
2011-11-19,3,Sharipov,Mello,Mello,Unanimous,Gomez,27,30,Luxenberg,27,30,Rodriguez,27,30,-3,-3,-3
2011-11-19,5,Rua,Henderson,Henderson,Unanimous,Mcknight,47,48,Morrow,47,48,Thomas-Gitlin,47,48,-1,-1,-1
2011-11-19,3,Story,Kampmann,Kampmann,Split,English,27,30,Morrow,28,29,Thomas-Gitlin,29,28,-3,-1,1
2011-11-19,3,Kingsbury,Bonnar,Bonnar,Unanimous,Denkin,25,30,English,27,30,Mcknight,27,30,-5,-3,-3
2011-11-19,3,dos Anjos,Tibau,Tibau,Split,English,29,28,Morrow,28,29,Thomas-Gitlin,27,30,1,-1,-3
2011-11-19,3,Pace,Torres,Torres,Unanimous,Denkin,27,30,English,27,30,Mcknight,27,30,-3,-3,-3
2011-11-18,3,Brunson,James,Brunson,Unanimous,Byrd,30,27,Morse Jarman,30,27,Trowbridge,30,27,3,3,3
2011-11-18,3,Cooper,Ricehouse,Ricehouse,Unanimous,Kamijo,27,29,Smith,26,30,Weeks,26,30,-2,-4,-4
2011-11-18,3,Mulhern,Hulett,Mulhern,Unanimous,Morse Jarman,29,28,Smith,29,28,Weeks,29,28,1,1,1
2011-11-12,3,Shlemenko,Vianna,Shlemenko,Unanimous,Jackson,30,27,Rodgers,30,27,Therien,29,28,3,3,1
2011-11-12,3,Hawk,Hollett,Hollett,Split,Bettes,28,29,Jackson,28,29,Rodgers,29,28,-1,-1,1
2011-11-12,12,Márquez,Pacquiao,Pacquiao,Majority,Hoyle,114,114,Moretti,113,115,Trowbridge,112,116,0,-2,-4
2011-11-12,3,Henderson,Guida,Henderson,Unanimous,Griffin,30,27,Hamilton,29,28,Lebell,30,27,3,1,3
2011-11-12,3,Uyenoyama,Yamamoto,Uyenoyama,Unanimous,Belardo,30,27,Hamilton,30,27,Lebell,30,26,3,3,4
2011-11-12,3,Caceres,Escovedo,Caceres,Unanimous,Belardo,30,27,Cobian,30,27,Lebell,30,27,3,3,3
2011-11-12,3,Bradley,Pierce,Pierce,Split,Cobian,28,29,Griffin,29,28,Hamilton,27,30,-1,1,-3
2011-11-12,3,Rosa,Lucas,Rosa,Majority,Belardo,30,26,Cobian,30,26,Lebell,28,28,4,4,0
2011-11-12,3,Corey,Horodecki,draw,Majority,Bettes,28,29,Jackson,28,28,Rodgers,28,28,-1,0,0
2011-11-05,3,Maguire,Edwards,Maguire,Unanimous,Collett,30,27,Urso,30,27,Watts,30,27,3,3,3
2011-11-05,3,De Fries,Broughton,De Fries,Unanimous,Urso,29,28,Watts,29,28,Winter,29,28,1,1,1
2011-11-05,3,Omigawa,Young,Omigawa,Unanimous,Collett,29,28,Hughes,29,28,Roberts,29,28,1,1,1
2011-11-05,3,Lee,Cariaso,Cariaso,Split,Collett,28,29,Watts,28,29,Winter,29,28,-1,-1,1
2011-10-29,5,Hieron,Askren,Askren,Unanimous,Boyd,47,48,Champion,47,48,Gueary,48,47,-1,-1,1
2011-10-29,3,Spoon,Schindler,Spoon,Unanimous,Boyd,29,28,Clifton,29,28,Gueary,30,27,1,1,3
2011-10-29,3,Navarro,Bears,Navarro,Split,Boyd,29,28,Clifton,29,28,Gueary,28,29,1,1,-1
2011-10-29,3,Tiller,Spohn,Tiller,Split,Boyd,30,27,Champion,28,29,Gueary,29,28,3,-1,1
2011-10-29,3,Brooks,de Souza,Brooks,Unanimous,Boyd,30,26,Champion,30,26,Gueary,29,27,4,4,2
2011-10-29,3,Diaz,Penn,Diaz,Unanimous,Byrd,29,28,Silbert,29,28,Weeks,29,27,1,1,2
2011-10-29,3,Kongo,Mitrione,Kongo,Unanimous,Hagen,29,28,Morse Jarman,30,27,Trowbridge,30,28,1,3,2
2011-10-29,3,Jorgensen,Curran,Jorgensen,Unanimous,Byrd,29,28,Silbert,29,28,Trowbridge,30,27,1,1,3
2011-10-29,3,Hioki,Roop,Hioki,Split,Hagen,28,29,Morse Jarman,29,28,Peoples,29,28,-1,1,1
2011-10-29,3,Marshall,Vera,Vera,Unanimous,Hagen,28,29,Kamijo,28,29,Peoples,28,29,-1,-1,-1
2011-10-29,3,Downes,Nijem,Nijem,Unanimous,Byrd,25,30,Morse Jarman,26,30,Smith,27,30,-5,-4,-3
2011-10-29,3,Camozzi,Carmont,Carmont,Unanimous,Peoples,27,30,Silbert,27,30,Weeks,26,30,-3,-3,-4
2011-10-29,3,Jacoby,Starks,Starks,Unanimous,Kamijo,27,30,Morse Jarman,27,30,Trowbridge,27,30,-3,-3,-3
2011-10-22,3,Galvão,Vila,Vila,Split,Cobian,28,29,Rogers,30,27,Urso,28,29,-1,3,-1
2011-10-22,3,Dantas,West,Dantas,Split,Cobian,28,29,Rogers,30,27,Urso,29,28,-1,3,1
2011-10-22,3,Wiuff,M'Pumbu,Wiuff,Unanimous,Cobian,29,28,Rogers,30,27,Urso,29,28,1,3,1
2011-10-22,3,Porter,Piedmont,Porter,Unanimous,Cobian,30,27,Rogers,29,28,Urso,30,27,3,1,3
2011-10-15,3,Kirwan,Nazare,Kirwan,Unanimous,Depasquale Jr.,30,27,Sanidad,29,28,Tamburrino,30,27,3,1,3
2011-10-15,3,Kelleher,Ledesma,Ledesma,Unanimous,Depasquale Jr.,27,30,Tamburrino,27,30,Tirelli,27,30,-3,-3,-3
2011-10-15,3,Wawro,Seiber,Wawro,Unanimous,Depasquale Jr.,29,28,Sanidad,29,28,Tirelli,29,28,1,1,1
2011-10-08,3,Bears,Matthews,Matthews,Unanimous,Lambert,28,29,Ritter,28,29,Sutherland,28,29,-1,-1,-1
2011-10-08,5,Aldo,Florian,Aldo,Unanimous,Crosby,49,46,Hamilton,49,46,Peoples,49,46,3,3,3
2011-10-08,3,Phan,Garcia,Phan,Unanimous,Dealejandro,29,28,Mathisen,29,28,Phillips,29,28,1,1,1
2011-10-08,3,Maia,Santiago,Maia,Unanimous,Hamilton,30,27,Mathisen,30,27,Phillips,30,27,3,3,3
2011-10-08,3,Stephens,Pettis,Pettis,Split,Crosby,28,29,Dealejandro,28,29,Phillips,29,28,-1,-1,1
2011-10-08,3,Beltran,Miocic,Miocic,Unanimous,Dealejandro,27,30,Mathisen,28,29,Phillips,28,29,-3,-1,-1
2011-10-08,3,Zhang,Elkins,Elkins,Unanimous,Dealejandro,27,30,Mathisen,26,30,Phillips,27,30,-3,-4,-3
2011-10-08,3,Schafer,Simpson,Simpson,Unanimous,Lassiter,27,30,Mathisen,27,30,Phillips,27,30,-3,-3,-3
2011-10-08,3,Cantwell,Massenzio,Massenzio,Unanimous,Dealejandro,28,29,Lassiter,28,29,Phillips,27,30,-1,-1,-3
2011-10-01,3,Hayes,Grove,Hayes,Split,Ancona,28,29,Barahona,29,28,Bass,29,28,-1,1,1
2011-10-01,3,Prindle,Wagner,Prindle,Unanimous,Ancona,29,28,Barahona,29,28,Bass,29,28,1,1,1
2011-10-01,3,Alexandre,Quayhagen,Quayhagen,Unanimous,Ancona,27,30,Bass,27,30,Manuel,27,30,-3,-3,-3
2011-10-01,5,Johnson,Cruz,Cruz,Unanimous,Bertrand,45,50,Blatnick,45,50,Urso,46,49,-5,-5,-3
2011-09-24,3,Beebe,Galvão,Galvão,Split,Austin,28,29,Barry,29,28,Beltz,28,29,-1,1,-1
2011-09-24,3,West,Nogueira,West,Unanimous,Austin,29,28,Barry,29,28,Beltz,30,27,1,1,3
2011-09-24,3,Eye,Noland,Eye,Split,Austin,29,28,Barry,29,28,Beltz,28,29,1,1,-1
2011-09-24,3,Sharipov,Riggleman,Riggleman,Split,Austin,28,29,Barry,29,28,Beltz,27,30,-1,1,-3
2011-09-24,3,Rothwell,Hunt,Hunt,Unanimous,Hamilton,28,29,Peoples,27,29,Van Tine,27,30,-1,-2,-3
2011-09-24,3,Broughton,Browne,Browne,Unanimous,Peoples,27,30,Van Tine,27,30,Weeks,27,30,-3,-3,-3
2011-09-24,3,Boetsch,Ring,Boetsch,Unanimous,Peoples,30,27,Thrasher,29,28,Van Tine,29,28,3,1,1
2011-09-24,3,Assunção,Yagin,Assunção,Unanimous,Peoples,30,26,Thrasher,30,26,Weeks,30,27,4,4,3
2011-09-23,3,Larkin,Rossborough,Larkin,Unanimous,Byrd,30,27,Kamijo,29,28,Trowbridge,30,27,3,1,3
2011-09-23,3,Couture,Watson,Couture,Majority,Byrd,28,28,Morse Jarman,29,28,Trowbridge,29,28,0,1,1
2011-09-23,3,High,Moore,High,Unanimous,Kamijo,30,27,Smith,30,27,Weeks,30,27,3,3,3
2011-09-23,3,Portela,Melancon,Melancon,Unanimous,Byrd,28,29,Smith,27,30,Weeks,28,29,-1,-3,-1
2011-09-23,3,Ray,Spang,Spang,Unanimous,Morse Jarman,28,29,Smith,28,29,Weeks,28,29,-1,-1,-1
2011-09-17,3,Alvey,Vianna,Vianna,Split,Gomez,28,29,Green,28,29,Rupert,29,28,-1,-1,1
2011-09-17,3,Martinez,van Hoven,Martinez,Unanimous,Gomez,30,27,Luxenberg,30,27,Rupert,30,27,3,3,3
2011-09-17,3,Kelly,Souza,Souza,Unanimous,Gomez,28,29,Luxenberg,28,29,Rupert,28,29,-1,-1,-1
2011-09-17,3,Reese,Brown,Reese,Unanimous,Gomez,30,27,Green,30,27,Luxenberg,30,27,3,3,3
2011-09-17,3,Yang,McGee,McGee,Unanimous,Blatnick,28,30,D'Amato,28,29,Lee,27,30,-2,-1,-3
2011-09-17,3,Brookins,Koch,Koch,Unanimous,Bertrand,27,30,Crosby,28,29,Scheuermann,27,30,-3,-1,-3
2011-09-17,3,Bailey,Dunham,Dunham,Unanimous,Barahona,27,30,Crosby,27,30,Lee,27,30,-3,-3,-3
2011-09-17,3,Riddle,Benoist,Benoist,Unanimous,Bertrand,28,29,Blatnick,28,29,D'Amato,28,29,-1,-1,-1
2011-09-17,3,Peralta,Lullo,Peralta,Unanimous,Bertrand,29,28,Lee,30,27,Scheuermann,30,27,1,3,3
2011-09-17,3,Lopez,Edwards,Edwards,Unanimous,Barahona,28,29,Blatnick,28,29,D'Amato,28,29,-1,-1,-1
2011-09-10,5,Souza,Rockhold,Rockhold,Unanimous,D'Amato,47,48,Lee,47,48,Snell,45,50,-1,-1,-5
2011-09-10,3,Kyle,de Lima,Kyle,Unanimous,Lee,29,28,Snell,29,28,Torriero,30,27,1,1,3
2011-09-10,3,Steele,Mierzwiak,Steele,Unanimous,Crawford,29,28,D'Amato,29,27,Lee,29,27,1,2,2
2011-09-10,3,Lozano,Weedman,Lozano,Unanimous,Almeida,29,28,Bittencourt,29,28,Urso,29,28,1,1,1
2011-09-10,3,Santos,Hornbuckle,Santos,Unanimous,Almeida,30,27,Bittencourt,30,27,Blatnick,30,27,3,3,3
2011-09-10,3,Lima,Carl,Lima,Unanimous,Almeida,29,28,Blatnick,30,27,Urso,30,27,1,3,3
2011-08-27,3,Barboza,Pearson,Barboza,Split,Lee,29,28,Roberts,29,28,Sutherland,28,29,1,1,-1
2011-08-27,3,Miller,Palhares,Palhares,Unanimous,Crosby,25,30,Lee,27,30,Roberts,27,29,-5,-3,-2
2011-08-27,3,Mitchell,Thiago,Thiago,Unanimous,D'Amato,27,30,Roberts,27,30,Sutherland,27,30,-3,-3,-3
2011-08-27,3,Assuncao,Eduardo,Assuncao,Unanimous,Crosby,30,27,Lee,30,27,Sutherland,30,27,3,3,3
2011-08-27,3,Alcântara,Arantes,Alcântara,Unanimous,D'Amato,30,27,Lee,29,28,Sutherland,30,27,3,1,3
2011-08-27,3,Loveland,Jabouin,Jabouin,Split,Crosby,28,29,Lee,28,29,Roberts,30,27,-1,-1,3
2011-08-20,3,Buentello,Konrad,Konrad,Unanimous,Avery,27,30,Bilyk,27,30,Urso,28,29,-3,-3,-1
2011-08-20,3,Matsuda,Almeida,Almeida,Unanimous,Bilyk,28,29,Rogers,27,30,Urso,27,30,-1,-3,-3
2011-08-14,3,Miller,Henderson,Henderson,Unanimous,Lee,26,30,Torriero,27,30,Winter,28,29,-4,-3,-1
2011-08-14,3,Sadollah,Ludwig,Ludwig,Unanimous,Lee,28,29,Torriero,28,29,Winter,28,29,-1,-1,-1
2011-08-14,3,Wineland,Benavidez,Benavidez,Unanimous,Lee,27,30,Torriero,27,30,Winter,27,30,-3,-3,-3
2011-08-14,3,Vemola,Markes,Markes,Unanimous,Lee,27,30,Torriero,27,30,Winter,27,30,-3,-3,-3
2011-08-14,3,Castillo,Volkmann,Volkmann,Unanimous,D'Amato,28,29,Hamilton,28,29,Trowbridge,28,29,-1,-1,-1
2011-08-12,3,Gurgel,Duarte,Duarte,Unanimous,Kamijo,28,29,Morse Jarman,27,30,Weeks,28,29,-1,-3,-1
2011-08-12,3,Villefort,James,James,Unanimous,Byrd,27,30,Smith,28,29,Trowbridge,28,29,-3,-1,-1
2011-08-12,3,Healy,Wisely,Healy,Unanimous,Byrd,30,27,Kamijo,30,27,Weeks,29,28,3,3,1
2011-08-12,3,Mehmen,Jones,Mehmen,Unanimous,Kamijo,30,27,Trowbridge,29,28,Weeks,30,27,3,1,3
2011-08-12,3,Berry,Villante,Villante,Unanimous,Byrd,27,30,Morse Jarman,27,30,Smith,27,30,-3,-3,-3
2011-08-06,3,Rivera,Philippou,Philippou,Split,Duruttya,28,29,Martin,29,28,Urso,28,29,-1,1,-1
2011-08-06,3,Yahya,Mendes,Mendes,Unanimous,Cintron,27,30,Crosby,27,30,Martin,27,30,-3,-3,-3
2011-08-06,3,Menjivar,Pace,Menjivar,Unanimous,Duruttya,29,28,Kao,29,28,Martin,29,28,1,1,1
2011-08-06,3,Pierce,Hendricks,Hendricks,Split,Cintron,28,29,Crosby,29,28,Kao,28,29,-1,1,-1
2011-08-06,3,Phan,Brown,Brown,Unanimous,Cintron,28,29,Duruttya,28,29,Kao,27,29,-1,-1,-2
2011-08-06,3,Natal,Bradley,Natal,Unanimous,Cintron,29,28,Kao,30,27,Urso,29,28,1,3,1
2011-07-30,3,Kennedy,Lawler,Kennedy,Unanimous,Bilus,30,27,Madrigal,30,27,Rodriguez,30,27,3,3,3
2011-07-30,3,Daley,Woodley,Woodley,Unanimous,Goodman,28,29,Holzemer,28,29,Sabaitis,28,29,-1,-1,-1
2011-07-30,3,Smith,Saffiedine,Saffiedine,Unanimous,D'Amato,26,30,Hunter,27,30,Morley,27,30,-4,-3,-3
2011-07-30,3,Green,Cavalcante,Cavalcante,Split,Bilus,28,29,Madrigal,28,29,Rodriguez,29,28,-1,-1,1
2011-07-30,3,Davis,Kedzie,Davis,Unanimous,Bilus,30,27,Madrigal,29,28,Rodriguez,30,27,3,1,3
2011-07-23,3,Curran,Mann,Curran,Unanimous,Jackson,29,28,Procopio,30,27,Rodgers,30,27,1,3,3
2011-07-23,3,Sandro,Malegarie,Sandro,Unanimous,Jackson,30,27,Procopio,30,27,Rodgers,30,27,3,3,3
2011-07-23,3,Horodecki,Saunders,Horodecki,Unanimous,Procopio,30,27,Rodgers,30,27,Valel,30,27,3,3,3
2011-07-23,3,Romero,Langbeen,Romero,Unanimous,Jackson,30,27,Procopio,29,28,Rodgers,30,27,3,1,3
2011-07-22,3,Cole,Jordan,Cole,Unanimous,Morse Jarman,29,28,Smith,29,28,Weeks,29,28,1,1,1
2011-07-22,3,Kaufman,Carmouche,Kaufman,Unanimous,Byrd,30,27,Morse Jarman,30,27,Smith,30,27,3,3,3
2011-07-22,3,Amagov,Stallings,Amagov,Split,Morse Jarman,29,28,Smith,28,29,Trowbridge,29,28,1,-1,1
2011-07-22,3,McLaughlin,Ford,Ford,Unanimous,Byrd,27,30,Trowbridge,27,30,Weeks,28,29,-3,-3,-1
2011-07-02,5,Cruz,Faber,Cruz,Unanimous,D'Amato,50,45,Morse Jarman,49,46,Trowbridge,48,47,5,3,1
2011-07-02,3,Wiman,Siver,Siver,Unanimous,Collins,28,29,Griffin,28,29,Trowbridge,28,29,-1,-1,-1
2011-07-02,3,Bowles,Mizugaki,Bowles,Unanimous,Collins,29,28,Griffin,30,27,Rosales,30,27,1,3,3
2011-07-02,3,Simpson,Tavares,Simpson,Unanimous,D'Amato,30,27,Griffin,30,27,Trowbridge,30,27,3,3,3
2011-07-02,3,Njokuani,Winner,Njokuani,Unanimous,Kamijo,30,26,Morse Jarman,30,27,Weeks,30,26,4,3,4
2011-07-02,3,Hougland,Walker,Hougland,Unanimous,Collins,29,28,Kamijo,29,28,Rosales,30,27,1,1,3
2011-06-26,3,Brenneman,Story,Brenneman,Unanimous,Crosby,29,28,Duruttya,29,28,Urso,29,28,1,1,1
2011-06-26,3,Howard,Brown,Brown,Unanimous,Crosby,28,29,Lapcevic,28,29,Urso,28,29,-1,-1,-1
2011-06-26,3,Gamburyan,Griffin,Griffin,Unanimous,Duruttya,28,29,Kruszka,28,29,Lapcevic,28,29,-1,-1,-1
2011-06-26,3,Vazquez,Stevenson,Vazquez,Unanimous,Colflesh,29,28,Lapcevic,30,27,Urso,30,27,1,3,3
2011-06-26,3,Attonito,Roberts,Attonito,Unanimous,Colflesh,29,28,Crosby,29,27,Lapcevic,30,27,1,2,3
2011-06-25,3,Sandro,da Silva,Sandro,Split,Bays,28,29,Green,29,28,Luxenberg,30,27,-1,1,3
2011-06-25,3,Esparza,Aguilar,Aguilar,Split,Bays,27,30,Gomez,29,28,Luxenberg,27,30,-3,1,-3
2011-06-25,3,Johnson,Lewis,Johnson,Unanimous,Gomez,29,28,Green,29,28,Luxenberg,29,28,1,1,1
2011-06-25,3,Samman,Cramer,Cramer,Unanimous,Bays,28,29,Green,28,29,Luxenberg,28,29,-1,-1,-1
2011-06-24,3,Terry,Fodor,Fodor,Unanimous,Beach,27,30,Boehlke,27,30,Corley,28,29,-3,-3,-1
2011-06-24,3,Couture,Ricehouse,Ricehouse,Unanimous,Beach,28,29,Boehlke,28,29,Corley,28,29,-1,-1,-1
2011-06-24,3,Larkin,Villante,Larkin,Unanimous,Beach,29,28,Boehlke,29,28,Corley,29,28,1,1,1
2011-06-24,3,High,Mulhern,High,Unanimous,Boehlke,30,27,Corley,30,27,Silbert,30,27,3,3,3
2011-06-24,3,de Randamie,Budd,Budd,Unanimous,Boehlke,28,29,Corley,28,29,Silbert,28,29,-1,-1,-1
2011-06-24,3,Brunson,Hamilton,Brunson,Unanimous,Beach,30,27,Boehlke,30,27,Corley,30,27,3,3,3
2011-06-18,3,Bronzoulis,Moore,Moore,Unanimous,Groom,28,29,Hamilton,28,29,Reyes,28,29,-1,-1,-1
2011-06-18,3,Overeem,Werdum,Overeem,Unanimous,Hamilton,29,28,Hatley,30,27,Peoples,30,27,1,3,3
2011-06-18,3,Noons,Masvidal,Masvidal,Unanimous,Groom,27,30,Hamilton,27,30,Reyes,27,30,-3,-3,-3
2011-06-18,3,Monson,Cormier,Cormier,Unanimous,Basinger,27,30,Groom,27,30,Peoples,27,30,-3,-3,-3
2011-06-18,3,Heun,Almeida,Heun,Unanimous,Basinger,29,28,Mathisen,29,28,Peoples,29,28,1,1,1
2011-06-18,3,Ray,Burrell,Burrell,Unanimous,Groom,28,29,Hamilton,28,29,Peoples,28,29,-1,-1,-1
2011-06-18,3,Vallie-Flagg,Melancon,Vallie-Flagg,Split,Basinger,28,29,Mathisen,29,28,Reyes,29,28,-1,1,1
2011-06-11,3,dos Santos,Carwin,dos Santos,Unanimous,D'Amato,30,27,Hamilton,30,27,Mahood,30,26,3,3,4
2011-06-11,3,Nunes,Florian,Florian,Unanimous,Darrah,28,29,Franco,28,29,Hagen,27,30,-1,-1,-3
2011-06-11,3,Munoz,Maia,Munoz,Unanimous,D'Amato,29,28,Darrah,29,28,Hamilton,30,27,1,1,3
2011-06-11,3,Rocha,Cerrone,Cerrone,Unanimous,Franco,26,30,Hagen,27,30,Hamilton,27,30,-4,-3,-3
2011-06-11,3,Soszynski,Massenzio,Soszynski,Unanimous,Franco,30,26,Hamilton,30,27,Mahood,30,27,4,3,3
2011-06-11,3,Young,Poirier,Poirier,Unanimous,D'Amato,28,29,Hagen,27,30,Mahood,27,30,-1,-3,-3
2011-06-11,3,Omigawa,Elkins,Elkins,Unanimous,Darrah,28,29,Hagen,27,30,Mahood,28,29,-1,-3,-1
2011-06-04,3,Guida,Pettis,Guida,Unanimous,Byrd,30,27,Crosby,30,27,Kamijo,30,27,3,3,3
2011-06-04,3,Kingsbury,Maldonado,Kingsbury,Unanimous,Byrd,29,28,Kamijo,29,28,Morse Jarman,29,28,1,1,1
2011-06-04,3,Cope,O'Neil,Cope,Unanimous,Crosby,30,27,D'Amato,30,27,Weeks,30,27,3,3,3
2011-06-04,3,Stephens,Downes,Stephens,Unanimous,D'Amato,30,26,Smith,30,27,Trowbridge,30,26,4,3,4
2011-06-04,3,McGillivray,Bailey,Bailey,Unanimous,Byrd,27,30,Kamijo,27,30,Smith,27,30,-3,-3,-3
2011-06-04,3,Edwards,Harvison,Harvison,Split,Crosby,29,28,D'Amato,28,29,Trowbridge,28,29,1,-1,-1
2011-05-28,3,Hamill,Jackson,Jackson,Unanimous,Silbert,27,30,Trowbridge,27,30,Weeks,27,30,-3,-3,-3
2011-05-28,3,Nelson,Mir,Mir,Unanimous,Byrd,27,30,Morse Jarman,26,30,Peoples,27,30,-3,-4,-3
2011-05-28,3,Story,Alves,Story,Unanimous,Morse Jarman,29,28,Silbert,29,28,Weeks,29,28,1,1,1
2011-05-28,3,Johnson,Torres,Johnson,Unanimous,Hagen,29,28,Trowbridge,29,28,Weeks,29,28,1,1,1
2011-05-28,3,Grove,Boetsch,Boetsch,Unanimous,Byrd,27,30,Kamijo,27,30,Morse Jarman,27,30,-3,-3,-3
2011-05-28,3,McDonald,Cariaso,McDonald,Split,Byrd,29,28,Trowbridge,29,28,Weeks,27,30,1,1,-3
2011-05-28,3,Escovedo,Barão,Barão,Unanimous,Kamijo,28,29,Morse Jarman,27,30,Silbert,27,30,-1,-3,-3
2011-05-21,3,Straus,Freire,Freire,Unanimous,Ancona,27,30,Bass,28,29,Leblanc,27,30,-3,-1,-3
2011-05-21,3,Alvey,Amoussou,Alvey,Split,Ancona,29,28,Bass,29,28,Leblanc,28,29,1,1,-1
2011-05-14,3,Freire,Chandler,Chandler,Unanimous,Agustin,27,29,Bilyk,27,29,Blatnick,27,29,-2,-2,-2
2011-05-14,3,Shlemenko,Cooper,Shlemenko,Unanimous,Bilyk,29,28,Blatnick,30,28,Sanidad,30,27,1,2,3
2011-05-14,3,Leone,Lentz,Lentz,Unanimous,Blatnick,28,29,Mason,28,29,Sanidad,28,29,-1,-1,-1
2011-05-14,3,Adkins,Silva,Silva,Unanimous,Blatnick,27,30,Mason,27,30,Sanidad,26,30,-3,-3,-4
2011-05-07,3,Hawn,Hieron,Hieron,Split,Greenwalt,29,28,Lambert,28,29,Ritter,28,29,1,-1,-1
2011-04-30,5,St-Pierre,Shields,St-Pierre,Unanimous,Bertrand,48,47,Crosby,50,45,Hamilton,48,47,1,5,1
2011-04-30,5,Hominick,Aldo,Aldo,Unanimous,Crosby,45,48,D'Amato,46,49,Hamilton,46,48,-3,-3,-2
2011-04-30,3,Henderson,Bocek,Henderson,Unanimous,Crosby,30,27,D'Amato,30,27,Paquette,30,27,3,3,3
2011-04-30,3,Diaz,MacDonald,MacDonald,Unanimous,Crosby,26,30,D'Amato,27,30,Paquette,26,30,-4,-3,-4
2011-04-30,3,Roberts,Patrick,Patrick,Unanimous,Bertrand,28,29,Hamilton,28,29,Procopio,28,29,-1,-1,-1
2011-04-23,3,Linderman,Hale,Hale,Split,Atwood,28,29,Greenwalt,29,28,Lambert,28,29,-1,1,-1
2011-04-23,3,Mann,Arocho,Mann,Unanimous,Atwood,30,27,Greenwalt,30,27,Lambert,30,25,3,3,5
2011-04-23,3,Spoon,Nogueira,Nogueira,Unanimous,Atwood,27,30,Greenwalt,28,29,Lambert,28,29,-3,-1,-1
2011-04-16,3,Galvão,Warren,Warren,Unanimous,Gueary,28,29,Mason,28,29,Wolfe,27,30,-1,-1,-3
2011-04-16,3,Piedmont,Parker,Piedmont,Split,Gueary,29,28,Mason,27,30,Wolfe,29,28,1,-3,1
2011-04-09,3,Thompson,Askren,Askren,Unanimous,Lambert,26,30,Ritter,27,30,Sutherland,27,30,-4,-3,-3
2011-04-09,3,Hieron,Weedman,Hieron,Unanimous,Lambert,29,28,Ritter,29,28,Sutherland,29,28,1,1,1
2011-04-09,3,Woodard,Chandler,Chandler,Unanimous,Lambert,28,29,Ritter,28,29,Sutherland,28,29,-1,-1,-1
2011-04-09,3,Stinson,James,Stinson,Split,Lambert,29,28,Ritter,28,29,Sutherland,29,28,1,-1,1
2011-04-09,3,Takaya,Peralta,Peralta,Split,Belardo,29,28,Griffin,27,30,Rochin,27,30,1,-3,-3
2011-04-09,3,Jardine,Mousasi,draw,Majority,Belardo,28,28,Cobian,27,29,Griffin,28,28,0,-2,0
2011-04-02,3,Cramer,Rebello,Cramer,Unanimous,Blatnick,30,27,Tirelli,30,27,Urso,30,27,3,3,3
2011-04-02,5,Curran,Alvarez,Alvarez,Unanimous,Miner,45,50,Tirelli,46,49,Urso,45,50,-5,-3,-5
2011-04-02,3,Hawn,Good,Hawn,Split,Blatnick,28,29,Miner,30,27,Urso,29,28,-1,3,1
2011-04-02,3,Winters,Quinn,Quinn,Unanimous,Miner,26,30,Tirelli,27,30,Urso,27,30,-4,-3,-3
2011-04-02,3,Tugman,McGlaughlin,McGlaughlin,Unanimous,Miner,28,29,Tirelli,28,29,Urso,28,29,-1,-1,-1
2011-04-01,3,Douglas,Phillips,Douglas,Split,English,28,29,Morrow,29,28,Thomas-Gitlin,30,27,-1,1,3
2011-03-26,3,Gracie,Carpenter,Carpenter,Split,Fisher,29,28,Leo,28,29,Presley,28,29,1,-1,-1
2011-03-26,3,Albin,Donovan,Donovan,Unanimous,Fisher,27,30,Leo,27,30,Presley,27,30,-3,-3,-3
2011-03-26,3,Wilson,Oselukwue,Oselukwue,Unanimous,Fisher,28,29,Leo,28,29,Presley,28,29,-1,-1,-1
2011-03-26,3,Davis,Nogueira,Davis,Unanimous,D'Amato,30,27,Griffin,30,27,Trowbridge,30,27,3,3,3
2011-03-26,3,Johnson,Hardy,Johnson,Unanimous,Griffin,30,27,Hagen,30,27,Lee,30,27,3,3,3
2011-03-26,3,Hathaway,McCray,Hathaway,Split,Corley,29,28,D'Amato,29,28,Griffin,28,29,1,1,-1
2011-03-26,3,McDonald,Figueroa,McDonald,Unanimous,Boehlke,30,27,Lee,30,27,Trowbridge,30,27,3,3,3
2011-03-26,3,Miranda,Simpson,Simpson,Unanimous,Boehlke,26,30,Lee,27,30,Trowbridge,27,30,-4,-3,-3
2011-03-19,3,Straus,Malegarie,Straus,Unanimous,Atwood,29,28,Greenwalt,29,28,Ritter,29,28,1,1,1
2011-03-19,3,Massouh,Delgado,Delgado,Unanimous,Atwood,28,29,Greenwalt,28,29,Ritter,27,30,-1,-1,-3
2011-03-19,3,Wineland,Faber,Faber,Unanimous,Bilyk,28,29,Bittencourt,28,29,Crosby,28,29,-1,-1,-1
2011-03-19,3,Marquardt,Miller,Marquardt,Unanimous,Bilyk,30,27,Crosby,30,27,Urso,30,27,3,3,3
2011-03-19,3,Barboza,Njokuani,Barboza,Unanimous,Bilyk,29,28,Sinclair,29,28,Tirelli,29,28,1,1,1
2011-03-19,3,Almeida,Pyle,Pyle,Unanimous,Crosby,28,29,Tamburrino,28,29,Urso,28,29,-1,-1,-1
2011-03-19,3,Pellegrino,Tibau,Tibau,Split,Crosby,28,29,Tamburrino,29,28,Urso,28,29,-1,1,-1
2011-03-19,3,Loveland,Benavidez,Benavidez,Unanimous,Bittencourt,28,29,Mason,27,30,Tirelli,27,30,-1,-3,-3
2011-03-19,3,Catone,Philippou,Catone,Unanimous,Bilyk,30,27,Sinclair,30,27,Tamburrino,30,27,3,3,3
2011-03-05,3,Spiritwolf,Jara,Spiritwolf,Split,Belardo,30,27,Denkin,29,28,Rosales,28,29,3,1,-1
2011-03-05,3,Good,Lozano,Good,Unanimous,Belardo,30,27,Denkin,29,28,Rosales,30,27,3,1,3
2011-03-05,3,Wallhead,Hawn,Hawn,Unanimous,Belardo,28,29,Denkin,28,29,Rosales,27,30,-1,-1,-3
2011-03-05,3,Weedman,Hornbuckle,Weedman,Unanimous,Belardo,29,28,Denkin,29,28,Rosales,29,28,1,1,1
2011-03-05,3,Frausto Gurgel,Hallinan,Frausto Gurgel,Unanimous,Belardo,30,27,Denkin,30,27,Rosales,30,27,3,3,3
2011-03-03,3,Kampmann,Sanchez,Sanchez,Unanimous,D'Amato,28,29,Lee,28,29,Mattingly,28,29,-1,-1,-1
2011-03-03,3,Weidman,Sakara,Weidman,Unanimous,Conley,30,27,D'Amato,30,27,Mattingly,30,27,3,3,3
2011-03-03,3,Cantwell,Diabaté,Diabaté,Unanimous,Conley,27,30,D'Amato,26,30,Tomazik,25,30,-3,-4,-5
2011-03-03,3,Castillo,Stevenson,Castillo,Unanimous,D'Amato,29,28,Lee,29,28,Tomazik,30,27,1,1,3
2011-03-03,3,Duran,Mizugaki,Mizugaki,Split,Blatnick,28,29,Mattingly,27,30,Tomazik,30,27,-1,-3,3
2011-02-27,3,Sotiropoulos,Siver,Siver,Unanimous,D'Amato,28,29,Papaioannou,28,30,Sutherland,27,30,-1,-2,-3
2011-02-27,3,Ebersole,Lytle,Ebersole,Unanimous,Bzadough,29,28,Foley,29,28,Lee,30,27,1,1,3
2011-02-27,3,Pearson,Fisher,Pearson,Unanimous,Bzadough,29,28,D'Amato,29,28,Lee,30,27,1,1,3
2011-02-27,3,Ring,Fukuda,Ring,Unanimous,Bzadough,29,28,D'Amato,29,28,Sutherland,29,28,1,1,1
2011-02-27,3,Warburton,Jewtuszko,Warburton,Unanimous,Bzadough,29,28,D'Amato,29,28,Sutherland,29,28,1,1,1
2011-02-27,3,Fitch,Penn,draw,Majority,D'Amato,28,28,Foley,29,28,Lee,28,28,0,1,0
2011-02-18,3,Beerbohm,Healy,Healy,Unanimous,Schorle,28,29,Townsend,28,29,Wright,28,29,-1,-1,-1
2011-02-12,3,Roddy,McLean,McLean,Unanimous,Bilyk,28,29,Rodriguez,28,29,Sinclair,28,29,-1,-1,-1
2011-02-05,3,Griffin,Franklin,Griffin,Unanimous,Crosby,29,28,Morse Jarman,29,28,Weeks,29,28,1,1,1
2011-02-05,3,Ellenberger,Rocha,Ellenberger,Split,Belardo,29,28,Byrd,27,30,Kamijo,29,28,1,-3,1
2011-02-05,3,Banuelos,Torres,Torres,Unanimous,Crosby,27,30,Kamijo,27,30,Weeks,27,30,-3,-3,-3
2011-02-05,3,Mendes,Omigawa,Mendes,Unanimous,D'Amato,30,27,Morse Jarman,30,27,Weeks,30,27,3,3,3
2011-02-05,3,Yamamoto,Johnson,Johnson,Unanimous,Belardo,27,30,Crosby,28,29,Kamijo,27,30,-3,-1,-3
2011-01-22,3,Beltran,Barry,Barry,Unanimous,Groom,27,30,Lee,28,29,Peoples,28,29,-3,-1,-1
2011-01-22,3,Wiman,Miller,Wiman,Unanimous,Hagen,30,27,Mathisen,29,28,Peoples,30,27,3,1,3
2011-01-22,3,Brown,Yahya,Yahya,Unanimous,Groom,28,29,Hagen,28,29,Mathisen,27,30,-1,-1,-3
2011-01-22,3,Freire,Lowe,Lowe,Unanimous,Groom,28,29,Lee,28,29,Peoples,28,29,-1,-1,-1
2011-01-22,3,Brenneman,Alves,Brenneman,Unanimous,Groom,30,27,Lee,30,27,Mathisen,30,27,3,3,3
2011-01-22,3,Cariaso,Campuzano,Cariaso,Unanimous,Hagen,29,28,Mathisen,29,28,Peoples,29,28,1,1,1
2011-01-07,3,Woodley,Saffiedine,Woodley,Unanimous,Bertrand,29,28,D'Amato,29,28,Maness,30,27,1,1,3
2011-01-01,3,Diaz,Kim,Kim,Unanimous,Byrd,28,29,Morse Jarman,28,29,Rosales,28,29,-1,-1,-1
2011-01-01,3,Poirier,Grispi,Poirier,Unanimous,Griffin,30,27,Morse Jarman,30,27,Weeks,30,27,3,3,3
2011-01-01,3,Nunes,Brown,Nunes,Split,Griffin,28,29,Morse Jarman,29,28,Trowbridge,29,28,-1,1,1
2011-01-01,3,Volkmann,McKee,Volkmann,Split,Kamijo,29,28,Trowbridge,29,28,Weeks,28,29,1,1,-1
2011-01-01,5,Maynard,Edgar,draw,Split,Morse Jarman,47,47,Rosales,46,48,Trowbridge,48,46,0,-2,2
2010-12-16,5,Henderson,Pettis,Pettis,Unanimous,Gabauer,47,48,Hamilton,46,49,Zazueta,47,48,-1,-3,-1
2010-12-16,5,Cruz,Jorgensen,Cruz,Unanimous,Flores,50,45,Gabauer,50,45,Zazueta,50,45,5,5,5
2010-12-16,3,Palaszewski,Shalorus,Shalorus,Split,Flores,27,30,Hamilton,29,28,Harmon,28,29,-3,1,-1
2010-12-16,3,Downes,Zhang,Downes,Unanimous,Flores,29,28,Harmon,30,27,Zazueta,29,28,1,3,1
2010-12-16,3,Pickett,Menjivar,Pickett,Unanimous,Gabauer,29,28,Hamilton,29,28,Harmon,29,28,1,1,1
2010-12-11,5,St-Pierre,Koscheck,St-Pierre,Unanimous,Hamilton,50,45,Therien,50,45,Woodburn,50,45,5,5,5
2010-12-11,3,Howard,Alves,Alves,Unanimous,Hamilton,27,30,Therien,27,30,Woodburn,27,30,-3,-3,-3
2010-12-11,3,Miller,Doerksen,Miller,Split,D'Amato,29,28,Decarufel,28,29,Weeks,29,28,1,-1,1
2010-12-11,3,Riddle,Pierson,Pierson,Unanimous,D'Amato,27,30,Hamilton,27,30,Therien,27,30,-3,-3,-3
2010-12-11,3,Almeida,Grant,Almeida,Unanimous,Decarufel,30,27,Hamilton,30,27,Weeks,30,27,3,3,3
2010-12-11,3,Audinwood,Makdessi,Makdessi,Unanimous,D'Amato,27,30,Therien,27,30,Woodburn,26,30,-3,-3,-4
2010-12-11,3,Natal,Bongfeldt,draw,Majority,D'Amato,28,28,Weeks,28,28,Woodburn,29,28,0,0,1
2010-12-04,3,Radach,Saint Preux,Saint Preux,Unanimous,D'Amato,25,30,Griffin,26,30,Harper,27,30,-5,-4,-3
2010-12-04,3,Phillips,Bettega,Phillips,Split,D'Amato,29,28,Harper,29,28,Wichgers,27,30,1,1,-3
2010-12-04,3,Martyniouk,Lawrence,Lawrence,Unanimous,Griffin,27,30,Harper,27,30,Wichgers,27,30,-3,-3,-3
2010-12-04,3,Ricehouse,Aaron,Ricehouse,Unanimous,Griffin,29,28,Harper,29,28,Wichgers,30,27,1,1,3
2010-12-04,3,Brookins,Johnson,Brookins,Unanimous,Byrd,29,28,Morse Jarman,29,27,Peoples,29,28,1,2,1
2010-12-04,3,Pokrajac,Bonnar,Bonnar,Unanimous,Peoples,26,29,Trowbridge,26,29,Weeks,26,29,-3,-3,-3
2010-12-04,3,Grove,Maia,Maia,Unanimous,Byrd,28,29,Kamijo,28,29,Morse Jarman,28,29,-1,-1,-1
2010-12-04,3,Story,Hendricks,Story,Unanimous,Morse Jarman,29,28,Trowbridge,29,28,Weeks,29,28,1,1,1
2010-12-04,3,Phan,Garcia,Garcia,Split,Byrd,28,29,Kamijo,30,27,Weeks,28,29,-1,3,-1
2010-12-04,3,Loveland,Toner,Loveland,Unanimous,Kamijo,29,28,Trowbridge,30,27,Weeks,30,26,1,3,4
2010-12-04,3,Chivitchian,Watson,Watson,Unanimous,Byrd,27,30,Morse Jarman,28,29,Peoples,27,30,-3,-1,-3
2010-12-04,3,Branch,Attonito,Branch,Unanimous,Byrd,30,27,Trowbridge,30,27,Weeks,30,27,3,3,3
2010-11-20,3,Machida,Jackson,Jackson,Split,Blatnick,28,29,D'Amato,28,29,Hamilton,29,28,-1,-1,1
2010-11-20,3,Harris,FalcÃ£o,FalcÃ£o,Unanimous,Blatnick,27,30,Caldwell,28,29,Urso,28,29,-3,-1,-1
2010-11-20,3,Munoz,Simpson,Munoz,Unanimous,Blatnick,29,28,Caldwell,29,28,Urso,29,28,1,1,1
2010-11-20,3,Lentz,Griffin,Lentz,Split,Blatnick,29,28,D'Amato,29,28,Hamilton,27,30,1,1,-3
2010-11-19,3,Wilcox,Ribeiro,Wilcox,Unanimous,Ferguson,30,27,Ingle,30,27,Leo,30,27,3,3,3
2010-11-19,3,Saint Preux,Britt,Saint Preux,Unanimous,Ferguson,29,28,Ingle,29,28,Leo,29,28,1,1,1
2010-11-13,3,Okami,Marquardt,Okami,Unanimous,Bertrand,29,28,Lee,30,27,Sutherland,29,28,1,3,1
2010-11-13,3,Sobotta,Sadollah,Sadollah,Unanimous,Bertrand,27,30,Hughes,27,30,Sutherland,27,30,-3,-3,-3
2010-11-13,3,Reljic,Soszynski,Soszynski,Unanimous,Lee,27,30,Sutherland,27,30,Watts,27,30,-3,-3,-3
2010-11-13,3,Osipczak,Ludwig,Ludwig,Split,Bertrand,28,29,Hughes,28,29,Watts,29,28,-1,-1,1
2010-11-13,3,Scanlon,Krauss,Krauss,Unanimous,Lee,27,30,Sutherland,27,30,Watts,27,30,-3,-3,-3
2010-11-11,3,Mendes,Vazquez,Mendes,Unanimous,Byrd,30,27,Hagen,30,27,Trowbridge,30,27,3,3,3
2010-11-11,3,Davis,Assuncao,Assuncao,Unanimous,Byrd,27,30,Morse Jarman,27,30,Silbert,27,30,-3,-3,-3
2010-11-11,3,Semerzier,Swanson,Swanson,Split,Hagen,29,28,Kamijo,28,29,Morse Jarman,28,29,1,-1,-1
2010-11-11,3,Jabouin,Visher,Jabouin,Unanimous,Byrd,30,27,Silbert,30,27,Weeks,30,27,3,3,3
2010-10-28,3,Kuhn,Kelly,Kelly,Unanimous,Green,28,29,Rupert,28,29,Vannatta,28,29,-1,-1,-1
2010-10-28,3,Gabin,Carrillo,Carrillo,Unanimous,Gomez,27,30,Green,27,30,Rupert,27,30,-3,-3,-3
2010-10-28,5,Lombard,Shlemenko,Lombard,Unanimous,Green,49,46,Rupert,49,46,Vannatta,49,46,3,3,3
2010-10-28,5,Fujii,Frausto Gurgel,Frausto Gurgel,Split,Gomez,47,48,Green,46,49,Rupert,48,47,-1,-3,1
2010-10-28,3,Tesanovic,Bernhard,Bernhard,Unanimous,Gomez,28,29,Rupert,27,30,Vannatta,28,29,-1,-3,-1
2010-10-28,3,Davis,Lopez,Davis,Unanimous,Gomez,30,27,Green,30,27,Vannatta,30,27,3,3,3
2010-10-23,3,Thiago,Sanchez,Sanchez,Unanimous,Beltran,28,29,Cobian,26,30,Landless,28,29,-1,-4,-1
2010-10-23,3,Ortiz,Hamill,Hamill,Unanimous,Beltran,28,29,Landless,28,29,Peoples,27,30,-1,-1,-3
2010-10-23,3,Schaub,Gonzaga,Schaub,Unanimous,Hamilton,30,27,Landless,30,27,Peoples,30,27,3,3,3
2010-10-23,3,Lawlor,Cote,Lawlor,Unanimous,Beltran,30,27,Cobian,30,27,Hamilton,30,27,3,3,3
2010-10-23,3,Stout,Taylor,Stout,Split,Beltran,29,28,Landless,28,29,Peoples,30,27,1,-1,3
2010-10-23,3,Yang,Camozzi,Camozzi,Split,Hamilton,28,29,Landless,29,28,Peoples,28,29,-1,1,-1
2010-10-21,5,Askren,Good,Askren,Unanimous,Cintron,49,46,Colflesh,50,45,Urso,48,47,3,5,1
2010-10-16,3,Bisping,Akiyama,Bisping,Unanimous,Crosby,30,27,Lee,30,27,Roberts,30,27,3,3,3
2010-10-16,3,Hathaway,Pyle,Pyle,Unanimous,Hughes,27,30,Lee,27,30,Roberts,27,30,-3,-3,-3
2010-10-16,3,Patrick,Wilks,Patrick,Unanimous,Hughes,30,27,Lee,30,27,Roberts,30,27,3,3,3
2010-10-16,3,Fisher,Warburton,Fisher,Unanimous,Crosby,29,28,Hughes,29,28,Sutherland,29,28,1,1,1
2010-10-16,3,Kongo,Browne,draw,Unanimous,Crosby,28,28,Lee,28,28,Watts,28,28,0,0,0
2010-10-14,3,Marriott,Roberts,Marriott,Unanimous,Griffin,29,28,Harper,30,27,Miller,29,28,1,3,1
2010-10-14,3,Tims,Downing,Downing,Split,Griffin,29,28,Harper,27,30,Miller,27,30,1,-3,-3
2010-10-14,5,West,Makovsky,Makovsky,Unanimous,Griffin,45,50,Harper,46,49,Miller,46,49,-5,-3,-3
2010-10-14,3,Thomas,Wallhead,Wallhead,Unanimous,Griffin,28,29,Harper,28,29,Miller,28,29,-1,-1,-1
2010-10-09,5,Noons,Diaz,Diaz,Unanimous,English,46,49,Morrow,46,49,Thomas-Gitlin,47,48,-3,-3,-1
2010-10-09,3,Cavalcante,Thomson,Thomson,Unanimous,Mcknight,28,29,Morrow,28,29,Thomas-Gitlin,27,30,-1,-1,-3
2010-09-30,3,Varner,Cerrone,Cerrone,Unanimous,Bates,27,30,Hamilton,27,30,Van Tine,27,30,-3,-3,-3
2010-09-30,3,Hominick,Garcia,Hominick,Split,Garcia,28,29,Hamilton,29,28,Van Tine,29,28,-1,1,1
2010-09-30,3,Ratcliff,Horodecki,Horodecki,Split,Bates,27,30,Garcia,27,30,Van Tine,29,28,-3,-3,1
2010-09-30,3,Nunes,Toner,Nunes,Unanimous,Garcia,29,28,Hamilton,30,27,Hilsabeck,29,28,1,3,1
2010-09-30,3,George,Banuelos,Banuelos,Unanimous,Bates,27,30,Hilsabeck,28,29,Van Tine,28,29,-3,-1,-1
2010-09-30,3,Johnson,Pace,Johnson,Unanimous,Bates,30,27,Garcia,30,27,Van Tine,30,27,3,3,3
2010-09-30,3,Aguilar,Frausto Gurgel,Frausto Gurgel,Split,Ancona,27,30,Manuel,30,27,Singletary,27,30,-3,3,-3
2010-09-25,3,Bader,Nogueira,Bader,Unanimous,Caldwell,30,27,D'Amato,30,27,Trowbridge,30,27,3,3,3
2010-09-25,3,Serra,Lytle,Lytle,Unanimous,D'Amato,27,30,Peoples,27,30,Trowbridge,27,30,-3,-3,-3
2010-09-25,3,Dunham,Sherk,Sherk,Split,Caldwell,29,28,Peoples,28,29,Trowbridge,28,29,1,-1,-1
2010-09-25,3,Guillard,Stephens,Guillard,Split,Caldwell,28,29,D'Amato,29,28,Torriero,30,27,-1,1,3
2010-09-25,3,Beltran,Mitrione,Mitrione,Unanimous,D'Amato,28,29,Peoples,28,29,Trowbridge,28,29,-1,-1,-1
2010-09-25,3,Lowe,Lopez,Lowe,Split,Peoples,29,28,Stone,28,29,Torriero,29,28,1,-1,1
2010-09-25,3,Paulino,Grant,Grant,Unanimous,Caldwell,27,30,Stone,27,30,Trowbridge,27,30,-3,-3,-3
2010-09-23,3,Clark,Troyer,Troyer,Unanimous,Evans,27,30,Kinman,27,30,Stapleton,27,30,-3,-3,-3
2010-09-23,3,Baker,Horn,Baker,Unanimous,Evans,29,28,Kinman,29,28,Stapleton,30,27,1,1,3
2010-09-23,3,Makovsky,Goldsby,Makovsky,Unanimous,Evans,29,28,Kinman,29,28,Stapleton,30,27,1,1,3
2010-09-23,3,Vega,West,West,Split,Evans,29,28,Kinman,28,29,Stapleton,28,29,1,-1,-1
2010-09-23,3,Riggs,Fleniken,Riggs,Unanimous,Evans,29,28,Kinman,29,28,Stapleton,29,28,1,1,1
2010-09-16,3,Guida,Lemke,Lemke,Split,D'Amato,28,29,Wichgers,29,28,Winter,28,29,-1,1,-1
2010-09-16,3,Konrad,Grabowski,Konrad,Unanimous,D'Amato,30,27,Wichgers,30,27,Winter,30,26,3,3,4
2010-09-16,3,Perkic,Dupees,Perkic,Unanimous,D'Amato,30,27,Wichgers,29,28,Winter,30,27,3,1,3
2010-09-15,3,Miller,Tibau,Miller,Unanimous,Lee,30,27,Peoples,30,27,Robbins,29,28,3,3,1
2010-09-15,3,Gunderson,Edwards,Edwards,Unanimous,Lee,27,30,Peoples,27,30,Robbins,27,30,-3,-3,-3
2010-09-15,3,Kingsbury,Hamman,Kingsbury,Unanimous,Lee,29,28,Peoples,29,28,Wright,29,28,1,1,1
2010-09-15,3,Branch,Drwal,Branch,Unanimous,Lee,30,27,Peoples,30,27,Robbins,30,27,3,3,3
2010-09-15,3,Natal,Attonito,Attonito,Unanimous,Lee,28,29,Peoples,28,29,Wright,27,30,-1,-1,-3
2010-09-15,3,Waldburger,Mitchell,Waldburger,Unanimous,Lee,30,27,Peoples,30,27,Robbins,30,27,3,3,3
2010-09-09,3,Kerry,Mackles,Mackles,Split,Ancona,28,29,Leblanc,27,30,Miller,29,28,-1,-3,1
2010-09-09,3,Vanier,Clementi,Vanier,Split,Ancona,28,29,Bass,29,28,Miller,29,28,-1,1,1
2010-09-09,3,Schambari,Horwich,Schambari,Split,Ancona,28,29,Bass,30,27,Miller,30,27,-1,3,3
2010-09-09,3,Karakhanyan,Leone,Karakhanyan,Unanimous,Ancona,30,27,Bass,29,28,Miller,30,27,3,1,3
2010-09-02,3,Barringer,Jimenez,Jimenez,Unanimous,Carrion,27,30,Crocker,28,29,Elizondo,28,29,-3,-1,-1
2010-09-02,3,Odoms,Mitchell,Odoms,Split,Carrion,29,28,Crocker,28,29,Elizondo,29,28,1,-1,1
2010-09-02,3,Christopher,Chappelle,Chappelle,Unanimous,Carrion,27,30,Crocker,27,30,Elizondo,27,30,-3,-3,-3
2010-09-02,3,Makovsky,Mamalis,Makovsky,Unanimous,Carrion,30,27,Crocker,30,27,Elizondo,30,27,3,3,3
2010-09-02,3,Goldsby,West,West,Unanimous,Carrion,27,30,Crocker,28,29,Elizondo,28,29,-3,-1,-1
2010-09-02,3,Reddinger,Gomez,Gomez,Split,Carrion,28,29,Crocker,28,29,Elizondo,29,28,-1,-1,1
2010-09-02,3,de la Cruz,Peterson,Peterson,Unanimous,Carrion,28,29,Crocker,27,30,Elizondo,27,30,-1,-3,-3
2010-08-28,5,Edgar,Penn,Edgar,Unanimous,D'Amato,50,45,Ginsberg,50,45,Peoples,50,45,5,5,5
2010-08-28,3,Miranda,Maia,Maia,Unanimous,D'Amato,27,30,Ginsberg,27,30,Peoples,27,30,-3,-3,-3
2010-08-28,3,Florian,Maynard,Maynard,Unanimous,D'Amato,27,30,Ginsberg,28,29,Peoples,27,30,-3,-1,-3
2010-08-28,3,Winner,Lentz,Lentz,Unanimous,Aliberti,27,30,D'Amato,28,29,Miner,27,30,-3,-1,-3
2010-08-28,3,Osipczak,Soto,Soto,Unanimous,Aliberti,28,29,Miner,28,29,Walls,28,29,-1,-1,-1
2010-08-26,3,Hayes,Oleinik,Oleinik,Split,Griffin,29,28,Harper,28,29,Miller,28,29,1,-1,-1
2010-08-26,3,Vega,Tims,Vega,Unanimous,Griffin,29,28,Harper,30,27,Miller,29,28,1,3,1
2010-08-26,3,Ellis,Daly,Ellis,Unanimous,Griffin,30,27,Harper,30,27,Miller,30,27,3,3,3
2010-08-26,3,Ott,Imes,Ott,Unanimous,Griffin,30,27,Harper,30,27,Miller,30,27,3,3,3
2010-08-21,5,Kennedy,Souza,Souza,Unanimous,Dealejandro,46,49,Patlán,47,48,Williams,47,48,-3,-1,-1
2010-08-21,3,Long,Magalhães,Magalhães,Unanimous,Dealejandro,28,29,Patlán,27,30,Williams,27,30,-1,-3,-3
2010-08-21,3,DeLeon,Robichaux,Robichaux,Split,Dealejandro,28,29,Patlán,28,29,Williams,29,28,-1,-1,1
2010-08-21,3,Young,Cook,Young,Unanimous,Dealejandro,30,27,Patlán,29,28,Williams,30,27,3,1,3
2010-08-19,3,Taylor,Carter,Taylor,Unanimous,D'Amato,30,26,Mcentire,30,27,Valdez,30,27,4,3,3
2010-08-19,3,Knabjian,Gassaway,Gassaway,Unanimous,Caldwell,28,29,Goodman,28,29,Puccillo,28,29,-1,-1,-1
2010-08-19,3,Konrad,Lloret,Konrad,Unanimous,Caldwell,30,27,Goodman,30,27,Puccillo,30,27,3,3,3
2010-08-19,3,Grabowski,Barrett,Grabowski,Unanimous,D'Amato,30,27,Mcentire,30,27,Valdez,30,27,3,3,3
2010-08-19,3,Hornbuckle,Blackburn,Hornbuckle,Unanimous,Caldwell,29,28,Goodman,29,28,Puccillo,29,28,1,1,1
2010-08-19,3,Frausto Gurgel,Penne,Frausto Gurgel,Unanimous,D'Amato,30,27,Mcentire,30,27,Valdez,30,27,3,3,3
2010-08-18,5,Benavidez,Cruz,Cruz,Split,Byrd,46,49,Griffin,47,48,Hamilton,48,47,-3,-1,1
2010-08-18,3,Swanson,Mendes,Mendes,Unanimous,Crosby,28,29,Griffin,28,29,Kamijo,27,30,-1,-1,-3
2010-08-18,3,Jorgensen,Pickett,Jorgensen,Unanimous,Byrd,30,27,Hamilton,30,27,Weeks,30,27,3,3,3
2010-08-18,3,Lamas,Jansen,Lamas,Unanimous,Crosby,29,28,Kamijo,29,28,Trowbridge,29,28,1,1,1
2010-08-18,3,Caraway,Paixão,Paixão,Split,Byrd,28,29,Kamijo,28,29,Trowbridge,29,28,-1,-1,1
2010-08-18,3,Poirier,Castillo,Castillo,Unanimous,Crosby,27,30,Morse Jarman,28,29,Weeks,27,30,-3,-1,-3
2010-08-12,3,Sharipov,Luke,Sharipov,Unanimous,Bays,30,27,Gomez,30,27,Torres,30,27,3,3,3
2010-08-12,3,Palomino,Edwards,Edwards,Unanimous,Bays,28,29,Gomez,28,29,Green,28,29,-1,-1,-1
2010-08-07,3,Alves,Fitch,Fitch,Unanimous,Hamilton,27,30,Stell,27,30,Thomas-Gitlin,27,30,-3,-3,-3
2010-08-07,3,Nelson,dos Santos,dos Santos,Unanimous,Rochin,27,30,Schorle,26,30,Stell,27,30,-3,-4,-3
2010-08-07,3,Brown,Boetsch,Boetsch,Unanimous,Hamilton,28,29,Rochin,28,29,Schorle,28,29,-1,-1,-1
2010-08-01,3,Okami,Munoz,Okami,Split,Cobian,29,28,Griffin,29,28,Peoples,28,29,1,1,-1
2010-07-23,3,Devela,Voelker,Voelker,Split,Moody,28,29,Nelson,28,29,Perry,29,28,-1,-1,1
2010-07-23,3,Diagne,Fodor,Fodor,Unanimous,Moody,27,30,Nelson,27,30,Perry,27,30,-3,-3,-3
2010-07-03,3,Pellegrino,Sotiropoulos,Sotiropoulos,Unanimous,D'Amato,27,30,Hamilton,27,30,Trowbridge,28,29,-3,-3,-1
2010-07-03,3,Reljic,Grove,Grove,Split,Morse Jarman,29,28,Peoples,28,29,Silbert,27,30,1,-1,-3
2010-07-03,3,Roberts,Petz,Roberts,Split,Morse Jarman,28,29,Silbert,29,28,Weeks,29,28,-1,1,1
2010-07-03,3,Madsen,Vemola,Madsen,Unanimous,D'Amato,30,27,Morse Jarman,30,27,Peoples,30,27,3,3,3
2010-06-24,3,Hinton,Straus,Straus,Unanimous,Caskey,27,30,Evans,27,30,Mooney,27,30,-3,-3,-3
2010-06-24,3,Warren,Freire,Warren,Split,Caskey,28,29,Evans,29,28,Mooney,29,28,-1,1,1
2010-06-20,3,Gomez,Fabiano,Fabiano,Unanimous,Bilocerkowec,27,30,Hamilton,27,30,Quwek,27,30,-3,-3,-3
2010-06-20,3,Cariaso,Rebello,Cariaso,Unanimous,Bilocerkowec,29,28,Edel,30,26,Quwek,29,28,1,4,1
2010-06-20,3,Varner,Shalorus,draw,Split,Hamilton,29,27,Peoples,28,28,Quwek,27,29,2,0,-2
2010-06-19,3,Jardine,Hamill,Hamill,Majority,Byrd,27,29,Morse Jarman,27,29,Weeks,28,28,-2,-2,0
2010-06-19,3,Siver,Fisher,Siver,Unanimous,Byrd,30,27,Collins,29,28,Morse Jarman,29,28,3,1,1
2010-06-19,3,Holst,Gunderson,Gunderson,Unanimous,Byrd,27,30,Collins,27,30,Griffin,27,30,-3,-3,-3
2010-06-19,3,Baczynski,Tavares,Tavares,Unanimous,Kamijo,28,29,Morse Jarman,28,29,Weeks,28,29,-1,-1,-1
2010-06-19,3,Hammortree,Camozzi,Camozzi,Unanimous,Griffin,27,30,Morse Jarman,28,29,Weeks,27,30,-3,-1,-3
2010-06-17,3,Hornbuckle,Askren,Askren,Unanimous,Griffin,27,30,Harper,27,30,Miller,27,30,-3,-3,-3
2010-06-17,3,Konrad,Orr,Konrad,Unanimous,Griffin,30,27,Harper,30,27,Miller,30,27,3,3,3
2010-06-16,3,Sobral,Lawler,Sobral,Unanimous,Belardo,29,28,Griffin,29,28,Hamilton,29,28,1,1,1
2010-06-16,3,Heun,Noons,Noons,Split,Belardo,30,27,Griffin,28,29,Hamilton,28,29,3,-1,-1
2010-06-12,3,Thiago,Kampmann,Kampmann,Unanimous,D'Amato,27,30,Franco,27,30,Weeks,27,30,-3,-3,-3
2010-06-12,3,Yvel,Rothwell,Rothwell,Unanimous,Hamilton,28,29,Mahood,27,30,Weeks,28,29,-1,-3,-1
2010-06-12,3,Griffin,Dunham,Dunham,Split,Franco,27,30,Gibson,28,29,Weeks,29,28,-3,-1,1
2010-06-12,3,Sobotta,Wilks,Wilks,Unanimous,Franco,27,30,Gibson,28,30,Hamilton,27,30,-3,-2,-3
2010-06-10,3,Palomino,Figueroa,Palomino,Unanimous,Gomez,29,28,Vannatta,29,28,Warring,29,28,1,1,1
2010-06-10,3,Imada,Curran,Curran,Split,Rupert,29,28,Vannatta,28,29,Warring,28,29,1,-1,-1
2010-06-10,3,Hayes,Banks,Hayes,Unanimous,Gomez,29,28,Rupert,29,28,Vannatta,29,28,1,1,1
2010-06-10,3,Chamale,Eckstein,Eckstein,Unanimous,Rupert,27,30,Vannatta,27,30,Warring,27,30,-3,-3,-3
2010-05-29,3,Jackson,Evans,Evans,Unanimous,D'Amato,28,29,Rosales,27,30,Trowbridge,27,30,-1,-3,-3
2010-05-29,3,Bisping,Miller,Bisping,Unanimous,Byrd,30,27,Morse Jarman,29,28,Weeks,30,27,3,1,3
2010-05-29,3,Nogueira,Brilz,Nogueira,Split,Morse Jarman,28,29,Rosales,29,28,Weeks,29,28,-1,1,1
2010-05-29,3,Sanchez,Hathaway,Hathaway,Unanimous,Byrd,27,30,Hagen,26,30,Trowbridge,27,30,-3,-4,-3
2010-05-29,3,Kim,Sadollah,Kim,Unanimous,D'Amato,30,27,Morse Jarman,30,27,Rosales,30,27,3,3,3
2010-05-29,3,Escudero,Lauzon,Escudero,Unanimous,Byrd,29,27,Hagen,29,27,Weeks,29,27,2,2,2
2010-05-29,3,Brammer,Riley,Riley,Unanimous,Hagen,27,30,Rosales,27,30,Trowbridge,27,30,-3,-3,-3
2010-05-27,3,Rosa,Villegas,Rosa,Unanimous,Carrion,29,28,Elizondo,30,27,Ramos,30,27,1,3,3
2010-05-27,3,Melancon,Schindler,Schindler,Unanimous,Carrion,27,30,Elizondo,27,30,Ramos,27,30,-3,-3,-3
2010-05-27,3,DeLeon,Flick,Flick,Unanimous,Carrion,28,29,Elizondo,27,30,Ramos,28,29,-1,-3,-1
2010-05-21,3,Coy,Woodley,Woodley,Split,Gregory,28,29,Senzer,28,29,Trachsel,30,27,-1,-1,3
2010-05-21,3,Bowling,Voelker,Bowling,Unanimous,Barringer,29,28,Campos,29,28,Richmond,29,28,1,1,1
2010-05-21,3,Travers,Healy,Healy,Unanimous,Barringer,28,29,Campos,28,29,Richmond,27,30,-1,-1,-3
2010-05-21,3,Escobedo,Sharp,Escobedo,Unanimous,Gregory,29,28,Senzer,29,28,Trachsel,29,28,1,1,1
2010-05-20,3,Thomas,Askren,Askren,Unanimous,Basinger,27,30,Groom,27,30,Mathisen,27,30,-3,-3,-3
2010-05-20,3,Smith,Winrow,Smith,Unanimous,Basinger,30,27,Groom,30,27,Mathisen,30,27,3,3,3
2010-05-15,3,Arlovski,Silva,Silva,Unanimous,D'Amato,28,29,Harper,28,29,Maness,27,30,-1,-1,-3
2010-05-15,3,Villasenor,Souza,Souza,Unanimous,D'Amato,28,29,Harper,28,29,Maness,28,29,-1,-1,-1
2010-05-15,3,Beerbohm,Ribeiro,Beerbohm,Split,D'Amato,28,29,Madison,30,27,Maness,30,27,-1,3,3
2010-05-15,3,DeRousse,Cobb,Cobb,Split,D'Amato,28,29,Madison,28,29,Maness,29,28,-1,-1,1
2010-05-13,3,Freire,Reis,Freire,Unanimous,Cox,29,28,Mccandlish,29,28,Singletary,29,28,1,1,1
2010-05-13,3,Karakhanyan,Warren,Warren,Unanimous,Cox,27,30,Mccandlish,27,30,Singletary,27,30,-3,-3,-3
2010-05-08,3,Daley,Koscheck,Koscheck,Unanimous,Hamilton,27,30,Paquette,27,30,Therien,27,30,-3,-3,-3
2010-05-08,3,Stout,Stephens,Stephens,Split,Procopio,27,30,Therien,28,29,Weeks,29,28,-3,-1,1
2010-05-08,3,Grant,Hendricks,Hendricks,Majority,D'Amato,28,28,Therien,27,29,Weeks,27,29,0,-2,-2
2010-05-08,3,Beltran,Hague,Beltran,Unanimous,Hamilton,30,27,Paquette,30,26,Procopio,29,28,3,4,1
2010-05-08,3,Yoshida,Guymon,Guymon,Unanimous,D'Amato,27,30,Therien,27,30,Weeks,27,30,-3,-3,-3
2010-05-06,3,Konrad,Bennett,Konrad,Unanimous,Aliberti,29,28,Ginsberg,30,26,Walls,30,27,1,4,3
2010-05-06,3,Huerta,Curran,Curran,Unanimous,Aliberti,28,29,Ginsberg,28,29,Walls,28,29,-1,-1,-1
2010-05-01,12,Mosley,Mayweather,Mayweather,Unanimous,Byrd,109,119,Hoyle,110,118,Moretti,109,119,-10,-8,-10
2010-04-29,3,Davidson,Tims,Tims,Unanimous,Griffin,28,29,Harper,27,30,Saulters,28,29,-1,-3,-1
2010-04-29,3,Major,Shlemenko,Shlemenko,Unanimous,Griffin,27,30,Harper,27,30,Saulters,27,30,-3,-3,-3
2010-04-24,5,Faber,Aldo,Aldo,Unanimous,Belardo,45,49,Hamilton,45,49,Stell,45,50,-4,-4,-5
2010-04-24,3,Jorgensen,Banuelos,Jorgensen,Unanimous,Belardo,29,28,Hamilton,29,28,Stell,29,28,1,1,1
2010-04-24,3,Jung,Garcia,Garcia,Split,Belardo,29,28,Hamilton,28,29,Stell,28,29,1,-1,-1
2010-04-24,3,Yahya,Mizugaki,Mizugaki,Unanimous,Belardo,28,29,Hamilton,27,30,Stell,28,29,-1,-3,-1
2010-04-22,3,Carl,Cooper,Carl,Split,Blatnick,28,29,Miner,29,28,Tirelli,29,28,-1,1,1
2010-04-17,5,Henderson,Shields,Shields,Unanimous,Bertrand,45,49,D'Amato,45,48,Maness,46,49,-4,-3,-3
2010-04-17,5,Melendez,Aoki,Melendez,Unanimous,Bertrand,50,45,D'Amato,50,45,Maness,50,45,5,5,5
2010-04-17,5,Mousasi,Lawal,Lawal,Unanimous,Bertrand,45,49,D'Amato,45,49,Maness,45,49,-4,-4,-4
2010-04-15,3,Curran,Goldsby,Goldsby,Unanimous,Caldwell,28,29,D'Amato,28,29,Morley,28,29,-1,-1,-1
2010-04-15,3,Rakoczy,Herrig,Herrig,Split,D'Amato,28,29,Goodman,28,29,Hecko,29,28,-1,-1,1
2010-04-10,5,Maia,Silva,Silva,Unanimous,Crosby,45,50,D'Amato,45,50,Hughes,46,49,-5,-5,-3
2010-04-10,5,Penn,Edgar,Edgar,Unanimous,Crosby,45,50,D'Amato,47,48,Roberts,46,49,-5,-1,-3
2010-04-10,3,Osipczak,Story,Story,Split,D'Amato,28,29,Hughes,28,29,Roberts,29,28,-1,-1,1
2010-04-10,3,Madsen,al Turk,Madsen,Unanimous,Crosby,29,28,Hughes,29,28,Roberts,29,28,1,1,1
2010-04-08,3,Warren,Marriott,Warren,Unanimous,Gomez,30,27,Lee,30,27,Vannatta,30,27,3,3,3
2010-04-08,3,Gomez,Gabin,Gomez,Unanimous,Davis,29,28,Gomez,29,28,Lee,29,28,1,1,1
2010-03-31,3,Pearson,Siver,Pearson,Unanimous,Crosby,30,27,Hopper Jr.,30,27,Lee,30,27,3,3,3
2010-03-27,5,St-Pierre,Hardy,St-Pierre,Unanimous,Blatnick,50,44,Crosby,50,43,Urso,50,45,6,7,5
2010-03-27,3,Saunders,Fitch,Fitch,Unanimous,Blatnick,27,30,Crosby,27,30,Urso,27,30,-3,-3,-3
2010-03-27,3,Bocek,Miller,Miller,Unanimous,Bilyk,28,29,Rodriguez,28,29,Urso,28,29,-1,-1,-1
2010-03-27,3,Wallace,Hamman,Hamman,Unanimous,Krawiec,28,29,Rodriguez,28,29,Tirelli,28,29,-1,-1,-1
2010-03-26,3,Galvão,Stewart,Galvão,Split,Belardo,30,27,Hamilton,29,28,Mcknight,27,30,3,1,-3
2010-03-26,3,Bailey,Wilcox,Wilcox,Unanimous,Belardo,27,30,Hamilton,26,30,Mcknight,27,30,-3,-4,-3
2010-03-21,3,Matyushenko,Marshall,Matyushenko,Split,Bates,30,27,Garcia,30,27,Thrasher,28,29,3,3,-1
2010-03-21,3,Paulino,Pierce,Pierce,Unanimous,Bates,27,30,Thrasher,27,30,Van Tine,27,30,-3,-3,-3
2010-03-21,3,Schafer,Brilz,Brilz,Unanimous,Bates,28,29,Garcia,28,29,Thrasher,28,29,-1,-1,-1
2010-03-06,3,Davis,Taurosevicius,Davis,Majority,Beltz,29,28,Blatnick,29,29,Urso,29,28,1,0,1
2010-03-06,3,Mendes,Koch,Mendes,Unanimous,Blatnick,30,27,Hiles,30,27,Urso,30,27,3,3,3
2010-03-06,3,Garcia,Roop,draw,Split,Crosby,27,29,Hiles,28,28,Urso,29,27,-2,0,2
2010-02-26,5,Hashi,Kaufman,Kaufman,Unanimous,Morrow,45,50,Rosales,45,50,Thomas-Gitlin,45,50,-5,-5,-5
2010-02-26,3,Terry,Saffiedine,Saffiedine,Unanimous,Morrow,27,30,Rosales,27,30,Thomas-Gitlin,27,30,-3,-3,-3
2010-02-26,3,Medeiros,Castillo,Medeiros,Unanimous,Morrow,30,27,Rosales,30,27,Thomas-Gitlin,30,27,3,3,3
2010-02-21,3,Silva,Bisping,Silva,Unanimous,D'Amato,29,28,Foley,29,28,Weeks,29,28,1,1,1
2010-02-21,3,Stevenson,Sotiropoulos,Sotiropoulos,Unanimous,Bzadough,27,30,Lee,27,30,Weeks,27,30,-3,-3,-3
2010-02-21,3,Dollaway,Reljic,Dollaway,Unanimous,Foley,29,28,Lee,29,28,Papaioannou,29,28,1,1,1
2010-02-06,3,Marquardt,Sonnen,Sonnen,Unanimous,Crosby,27,30,Griffin,27,30,Weeks,27,30,-3,-3,-3
2010-02-06,3,Maia,Miller,Maia,Unanimous,Byrd,30,27,Crosby,29,28,Griffin,29,28,3,1,1
2010-02-06,3,Danzig,Buchholz,Danzig,Unanimous,Byrd,29,28,Griffin,29,28,Trowbridge,29,28,1,1,1
2010-02-06,3,Torres,Guillard,Guillard,Unanimous,Crosby,28,29,Morse Jarman,28,29,Weeks,28,29,-1,-1,-1
2010-02-06,3,Emerson,Nover,Emerson,Unanimous,Byrd,29,28,Hamilton,29,28,Weeks,29,28,1,1,1
2010-02-06,3,Stann,Davis,Davis,Unanimous,Griffin,27,30,Morse Jarman,26,30,Trowbridge,26,30,-3,-4,-4
2010-02-06,3,Tuchscherer,Hague,Tuchscherer,Majority,Crosby,28,28,Hamilton,29,28,Trowbridge,29,28,0,1,1
2010-01-30,3,Hieron,Riggs,Hieron,Unanimous,Gomez,30,27,Green,30,27,Lee,29,28,3,3,1
2010-01-30,3,Oxley,Gomez,Gomez,Unanimous,Gomez,27,30,Lee,27,30,Vannatta,27,30,-3,-3,-3
2010-01-11,3,Diaz,Maynard,Maynard,Split,Crosby,27,30,D'Amato,29,28,Urso,28,29,-3,1,-1
2010-01-11,3,Simpson,Lawlor,Simpson,Split,Blatnick,28,29,Colón,29,28,D'Amato,29,28,-1,1,1
2010-01-11,3,Sadollah,Blackburn,Sadollah,Unanimous,Colón,30,27,Crosby,30,27,Urso,30,27,3,3,3
2010-01-11,3,Silva,Leben,Leben,Unanimous,Blatnick,27,30,Crosby,27,30,D'Amato,27,30,-3,-3,-3
2010-01-11,3,Lennox,Story,Story,Split,Blatnick,27,30,Colón,29,28,Urso,27,30,-3,1,-3
2010-01-11,3,Bradley,dos Anjos,dos Anjos,Unanimous,Crosby,27,30,Urso,27,30,Walters,27,30,-3,-3,-3
2010-01-11,3,Forbes,Catone,Catone,Split,Crosby,28,29,D'Amato,28,29,Walters,29,28,-1,-1,1
2010-01-11,3,Lentz,Tavares,draw,Majority,Colón,28,28,D'Amato,28,28,Urso,29,27,0,0,2
2010-01-10,3,Jansen,Shalorus,Shalorus,Unanimous,English,28,29,Hamilton,27,30,Rosales,27,30,-1,-3,-3
2010-01-10,3,Tamura,Valencia,Valencia,Split,Bertrand,29,28,English,28,29,Rosales,28,29,1,-1,-1
2010-01-10,3,Wheeler,Campuzano,Campuzano,Unanimous,Bertrand,27,30,English,27,30,Hamilton,26,30,-3,-3,-4
2010-01-02,3,Silva,Evans,Evans,Unanimous,Byrd,28,29,Silbert,28,29,Weeks,28,29,-1,-1,-1
2010-01-02,3,Lauzon,Stout,Stout,Unanimous,D'Amato,27,30,Peoples,27,30,Weeks,26,30,-3,-3,-4
2010-01-02,3,Gunderson,Oliveira,Oliveira,Unanimous,Peoples,27,30,Silbert,27,30,Trowbridge,27,30,-3,-3,-3
2009-12-29,3,Mizugaki,Jorgensen,Jorgensen,Unanimous,Morse Jarman,28,29,Rosales,28,29,Trowbridge,28,29,-1,-1,-1
2009-12-29,3,Pettis,Palaszewski,Palaszewski,Split,Hagen,27,30,Kamijo,28,29,Trowbridge,30,27,-3,-1,3
2009-12-29,3,Corbbrey,Micklewright,Micklewright,Unanimous,Byrd,27,30,Rosales,27,30,Weeks,27,30,-3,-3,-3
2009-12-29,3,Hosman,George,George,Unanimous,Hagen,27,30,Kamijo,27,30,Morse Jarman,27,30,-3,-3,-3
2009-12-29,3,Massouh,Koch,Koch,Unanimous,Byrd,27,30,Hagen,27,30,Trowbridge,27,30,-3,-3,-3
2009-12-19,5,Melendez,Thomson,Melendez,Unanimous,Hamilton,49,46,Morrow,49,46,Peoples,49,47,3,3,2
2009-12-05,3,Alexander,Slice,Slice,Unanimous,Hagen,27,30,Trowbridge,28,29,Weeks,28,29,-3,-1,-1
2009-12-05,3,Madsen,Wren,Madsen,Split,Byrd,30,27,D'Amato,28,29,Trowbridge,29,28,3,-1,1
2009-12-05,3,Wallace,Stann,Stann,Unanimous,Hagen,28,29,Peoples,28,29,Weeks,27,30,-1,-1,-3
2009-11-21,3,Griffin,Ortiz,Griffin,Split,Griffin,30,27,Rosales,29,28,Trowbridge,28,29,3,1,-1
2009-11-21,3,Volkmann,Thiago,Thiago,Unanimous,Collins,27,30,Silbert,27,30,Trowbridge,28,29,-3,-3,-1
2009-11-21,3,Baroni,Sadollah,Sadollah,Unanimous,Collins,27,30,Morse Jarman,27,30,Weeks,28,29,-3,-3,-1
2009-11-21,3,Uno,Camões,draw,Majority,Morse Jarman,29,27,Rosales,28,28,Trowbridge,28,28,2,0,0
2009-11-20,3,Cobb,Tapusoa,Cobb,Split,Boyd,28,29,Gueary,30,27,Saulters,29,28,-1,3,1
2009-11-18,3,Gamburyan,Garcia,Gamburyan,Unanimous,Belardo,29,28,Morse Jarman,29,28,Trowbridge,30,27,1,1,3
2009-11-18,3,Darabedyan,McCullough,Darabedyan,Split,Byrd,29,28,Kamijo,30,27,Weeks,27,30,1,3,-3
2009-11-18,3,Nunes,Davis,Davis,Unanimous,Byrd,26,30,Hamilton,26,30,Morse Jarman,26,30,-4,-4,-4
2009-11-18,3,Banuelos,Osawa,Banuelos,Unanimous,Byrd,29,28,Morse Jarman,29,28,Trowbridge,29,28,1,1,1
2009-11-18,3,Lamas,Krause,Lamas,Unanimous,Belardo,30,27,Hamilton,30,27,Weeks,30,27,3,3,3
2009-11-18,3,Gomez,Dikun,Gomez,Unanimous,Hamilton,30,27,Kamijo,30,27,Trowbridge,29,28,3,3,1
2009-11-14,3,Couture,Vera,Couture,Unanimous,D'Amato,29,28,Roberts,29,28,Trowbridge,29,28,1,1,1
2009-11-14,3,Swick,Hardy,Hardy,Unanimous,D'Amato,28,29,Sutherland,28,30,Watts,27,30,-1,-2,-3
2009-11-14,3,Taylor,Hathaway,Hathaway,Unanimous,Hughes,27,30,Sutherland,26,30,Watts,27,30,-3,-4,-3
2009-11-07,5,Shields,Miller,Shields,Unanimous,Caldwell,49,46,D'Amato,49,46,Rosales,48,47,3,3,1
2009-11-06,3,Gurgel,Evangelista,Evangelista,Unanimous,Belardo,27,30,Mcknight,27,30,Thomas-Gitlin,28,29,-3,-3,-1
2009-11-06,3,Frausto Gurgel,Helsper,Frausto Gurgel,Unanimous,Belardo,30,27,Mcknight,30,27,Thomas-Gitlin,30,27,3,3,3
2009-11-06,3,Goh,Holscher,Holscher,Unanimous,Belardo,27,30,Mcknight,27,30,Thomas-Gitlin,27,30,-3,-3,-3
2009-11-06,3,Trevino,Altamirano,Altamirano,Unanimous,Belardo,27,30,Mcknight,27,30,Thomas-Gitlin,27,30,-3,-3,-3
2009-10-24,5,Rua,Machida,Machida,Unanimous,Hamilton,47,48,Peoples,47,48,Rosales,47,48,-1,-1,-1
2009-10-24,3,Okami,Sonnen,Sonnen,Unanimous,Hamilton,27,30,Peoples,27,30,Weeks,27,30,-3,-3,-3
2009-10-24,3,Kingsbury,Al-Hassan,Kingsbury,Split,Hamilton,29,28,Peoples,29,28,Thomas-Gitlin,28,29,1,1,-1
2009-10-10,5,Henderson,Cerrone,Henderson,Unanimous,Carrion,48,47,Crocker,48,47,Townsend,48,47,1,1,1
2009-10-10,3,Crunkilton,Jansen,Jansen,Unanimous,Carrion,28,29,Crocker,27,30,Townsend,28,29,-1,-3,-1
2009-10-10,3,Assuncao,Jabouin,Assuncao,Split,Carrion,27,30,Elizondo,29,28,Townsend,30,27,-3,1,3
2009-10-10,3,Tapia,Wineland,Wineland,Unanimous,Carrion,27,30,Elizondo,27,30,Townsend,27,30,-3,-3,-3
2009-10-10,3,Valencia,Wheeler,Valencia,Unanimous,Carrion,29,28,Crocker,29,28,Hatley,30,27,1,1,3
2009-10-10,3,Vazquez,Taurosevicius,Taurosevicius,Split,Carrion,29,28,Elizondo,28,29,Townsend,28,29,1,-1,-1
2009-09-19,3,Lentz,Oliveira,Lentz,Unanimous,Armstrong,29,28,Crosby,30,27,Peoples,29,28,1,3,1
2009-09-19,3,Brilz,Marshall,Marshall,Split,Basinger,27,30,Lee,30,27,Peoples,27,30,-3,3,-3
2009-09-19,3,Pokrajac,Matyushenko,Matyushenko,Unanimous,D'Amato,27,30,Douglas,27,30,Lee,27,30,-3,-3,-3
2009-09-19,3,Emerson,dos Anjos,dos Anjos,Unanimous,Armstrong,27,30,Crosby,27,30,Peoples,27,30,-3,-3,-3
2009-09-16,3,Huerta,Maynard,Maynard,Split,Lee,29,28,Peoples,27,30,Trowbridge,27,30,1,-3,-3
2009-09-16,3,Ellenberger,Condit,Condit,Split,D'Amato,28,29,Lee,28,29,Peoples,29,28,-1,-1,1
2009-09-16,3,Credeur,Quarry,Quarry,Unanimous,D'Amato,28,29,Peoples,27,29,Trowbridge,28,29,-1,-2,-1
2009-09-16,3,Stann,Cantwell,Stann,Unanimous,Higdon,30,27,Lambert,30,27,Lee,29,28,3,3,1
2009-09-16,3,Dollaway,Silva,Dollaway,Unanimous,Lambert,29,28,Lee,29,28,Ritter,29,28,1,1,1
2009-09-16,3,Larson,Pierce,Pierce,Unanimous,Higdon,27,30,Lee,27,30,Trowbridge,27,30,-3,-3,-3
2009-08-29,3,Couture,Nogueira,Nogueira,Unanimous,Hamilton,27,30,Rosales,27,30,Trowbridge,28,29,-3,-3,-1
2009-08-29,3,Soszynski,Vera,Vera,Unanimous,Hagen,27,30,Hamilton,27,30,Rosales,27,30,-3,-3,-3
2009-08-29,3,McCully,Russow,Russow,Unanimous,Rosales,26,30,Trachsel,28,29,Trowbridge,27,30,-4,-1,-3
2009-08-29,3,Catone,Munoz,Munoz,Split,Barringer,29,28,Rosales,27,30,Trowbridge,28,29,1,-3,-1
2009-08-29,3,Dunham,Aurélio,Dunham,Split,Griffin,30,27,Hamilton,29,28,Richmond,28,29,3,1,-1
2009-08-09,3,Cruz,Benavidez,Cruz,Unanimous,D'Amato,29,28,Griffin,29,28,Trowbridge,30,27,1,1,3
2009-08-09,3,Mizugaki,Curran,Mizugaki,Split,Byrd,29,28,D'Amato,29,28,Trowbridge,28,29,1,1,-1
2009-08-09,3,Garcia,Massouh,Garcia,Split,Griffin,29,28,Hagen,29,28,Weeks,28,29,1,1,-1
2009-08-09,3,Hicks,Roller,Roller,Unanimous,Griffin,27,30,Trowbridge,28,29,Weeks,27,30,-3,-1,-3
2009-08-09,3,Ratcliff,Cardella,Ratcliff,Unanimous,Byrd,30,27,Hagen,30,27,Kamijo,29,28,3,3,1
2009-08-09,3,Dias,Nunes,Nunes,Unanimous,Hagen,27,30,Kamijo,27,30,Trowbridge,27,30,-3,-3,-3
2009-08-09,3,Vazquez,Davis,Davis,Split,D'Amato,27,30,Griffin,29,28,Weeks,28,29,-3,1,-1
2009-08-08,3,Riley,Nelson,Riley,Unanimous,Blatnick,30,27,Colón,30,27,Hamilton,30,27,3,3,3
2009-08-08,3,Almeida,Grove,Almeida,Unanimous,Blatnick,30,27,Crosby,30,27,Hamilton,30,27,3,3,3
2009-08-08,3,Neer,Pellegrino,Pellegrino,Unanimous,Colón,27,30,Duruttya,27,30,Urso,27,30,-3,-3,-3
2009-08-08,3,Howard,McCrory,Howard,Split,Crosby,29,28,Duruttya,28,29,Urso,29,28,1,-1,1
2009-08-08,3,Sakara,Leites,Sakara,Split,Blatnick,29,28,Hamilton,29,28,Urso,27,30,1,1,-3
2009-08-08,3,Riddle,Cramer,Riddle,Unanimous,Colón,29,27,Crosby,30,26,Duruttya,30,27,2,4,3
2009-07-11,3,Fitch,Thiago,Fitch,Unanimous,Morse Jarman,29,28,Peoples,29,28,Weeks,30,27,1,1,3
2009-07-11,5,Alves,St-Pierre,St-Pierre,Unanimous,Byrd,45,50,Crosby,44,50,Rosales,45,50,-5,-6,-5
2009-07-11,3,Akiyama,Belcher,Akiyama,Split,Byrd,30,27,Crosby,28,29,Morse Jarman,29,28,3,-1,1
2009-07-11,3,Coleman,Bonnar,Coleman,Unanimous,Hamilton,29,28,Rosales,29,28,Weeks,29,28,1,1,1
2009-07-11,3,Miller,Danzig,Miller,Unanimous,Crosby,30,27,Rosales,30,27,Trowbridge,30,27,3,3,3
2009-07-11,3,Grant,Kim,Kim,Unanimous,Crosby,26,30,Peoples,26,30,Weeks,26,30,-4,-4,-4
2009-06-20,3,Guida,Sanchez,Sanchez,Split,Hamilton,28,29,Morse Jarman,29,28,Trowbridge,27,29,-1,1,-2
2009-06-20,3,Burns,Lytle,Lytle,Unanimous,Belardo,28,29,Byrd,28,29,Hagen,28,29,-1,-1,-1
2009-06-20,3,Pearson,Winner,Pearson,Unanimous,Hamilton,29,28,Trowbridge,29,28,Weeks,29,28,1,1,1
2009-06-20,3,Diaz,Stevenson,Stevenson,Unanimous,Belardo,28,29,Morse Jarman,28,29,Rosales,28,29,-1,-1,-1
2009-06-20,3,Tibau,Guillard,Guillard,Split,Hagen,28,29,Hamilton,29,28,Trowbridge,28,29,-1,1,-1
2009-06-20,3,Garcia,Blackburn,Blackburn,Split,Byrd,29,28,Morse Jarman,28,29,Weeks,28,29,1,-1,-1
2009-06-19,3,Gerhart,Palomino,Palomino,Unanimous,Gomez,28,29,Rupert,28,29,Vannatta,28,29,-1,-1,-1
2009-06-19,3,Villasenor,Santos,Villasenor,Split,Boehlke,29,28,Corley,29,28,Perry,28,29,1,1,-1
2009-06-19,3,Gurgel,Heun,Gurgel,Unanimous,Beach,30,27,Boehlke,30,27,Corley,29,28,3,3,1
2009-06-19,3,Baszler,Kaufman,Kaufman,Unanimous,Beach,27,30,Boehlke,28,29,Corley,27,30,-3,-1,-3
2009-06-13,3,Silva,Franklin,Franklin,Unanimous,Lee,27,30,Roberts,28,29,Weeks,27,30,-3,-1,-3
2009-06-13,3,Kongo,Velasquez,Velasquez,Unanimous,Crosby,27,30,Hughes,27,30,Watts,27,30,-3,-3,-3
2009-06-13,3,Uno,Fisher,Fisher,Unanimous,Roberts,28,29,Watts,28,29,Weeks,28,29,-1,-1,-1
2009-06-13,3,Davis,Hardy,Hardy,Split,Crosby,28,29,Roberts,29,28,Weeks,28,29,-1,1,-1
2009-06-13,3,Taylor,Sobotta,Taylor,Unanimous,Lee,30,27,Watts,30,27,Weeks,30,27,3,3,3
2009-06-13,3,Delgado,Kelly,Kelly,Unanimous,Hughes,28,29,Lee,28,29,Weeks,28,29,-1,-1,-1
2009-06-13,3,Hathaway,Story,Hathaway,Unanimous,Crosby,29,28,Hughes,30,27,Roberts,29,28,1,3,1
2009-06-12,3,Torrey,Makowski,Torrey,Unanimous,Blatnick,29,28,Krawiec,29,28,Rogers,30,27,1,1,3
2009-06-12,3,Garcia,Rivera,Rivera,Unanimous,Blatnick,27,30,Krawiec,27,30,Rogers,27,30,-3,-3,-3
2009-06-07,5,Brown,Faber,Brown,Unanimous,Hamilton,49,46,Rosales,49,46,Weeks,48,47,3,3,1
2009-06-07,3,Gamburyan,Franchi,Gamburyan,Unanimous,Rosales,30,27,Schorle,30,27,Thomas-Gitlin,30,27,3,3,3
2009-06-07,3,Jorgensen,Banuelos,Banuelos,Split,Hamilton,28,29,Schorle,29,28,Weeks,28,29,-1,1,-1
2009-06-05,3,Reis,Vargas,Reis,Split,Denkin,28,29,Griffin,29,28,Lebell,29,28,-1,1,1
2009-06-05,3,Baker,Horwich,Baker,Unanimous,Denkin,30,27,Griffin,30,27,Lebell,30,27,3,3,3
2009-06-05,3,Clark,Browne,Browne,Unanimous,Denkin,28,29,Griffin,28,29,Lebell,28,29,-1,-1,-1
2009-06-05,3,Gomez,Juarez,Juarez,Unanimous,Denkin,27,30,Griffin,27,30,Lebell,27,30,-3,-3,-3
2009-05-23,3,Hughes,Serra,Hughes,Unanimous,Collins,29,28,Griffin,29,28,Weeks,29,28,1,1,1
2009-05-23,3,Miller,Sonnen,Sonnen,Unanimous,Byrd,27,30,Griffin,27,30,Silbert,27,30,-3,-3,-3
2009-05-23,3,Sherk,Edgar,Edgar,Unanimous,Collins,27,30,Morse Jarman,27,30,Weeks,27,30,-3,-3,-3
2009-05-23,3,Roop,Kaplan,Roop,Split,D'Amato,30,27,Griffin,30,27,Weeks,28,29,3,3,-1
2009-05-15,3,Smith,Vera,Vera,Unanimous,Bilus,28,29,D'Amato,27,30,Valdez,27,30,-1,-3,-3
2009-05-08,3,Reis,Soto,Soto,Unanimous,Garcia,27,30,Rogers,27,30,Rogers,27,30,-3,-3,-3
2009-05-08,3,Vargas,Pineda,Vargas,Unanimous,Garcia,30,27,Rogers,29,28,Rogers,29,28,3,1,1
2009-05-01,3,Lowe,Caraballo,Lowe,Unanimous,Blevins,30,27,Connors,30,27,Goodwine,30,27,3,3,3
2009-04-18,5,Leites,Silva,Silva,Unanimous,Crosby,46,49,Hamilton,47,48,Roussel,46,49,-3,-1,-3
2009-04-18,3,Wiman,Stout,Stout,Unanimous,Paquette,28,29,Peoples,28,29,Roussel,28,29,-1,-1,-1
2009-04-18,3,Cantwell,Cane,Cane,Unanimous,Hamilton,28,29,Leblanc,27,30,Peoples,27,30,-1,-3,-3
2009-04-18,3,Kang,Foupa-Pokam,Kang,Unanimous,Crosby,30,27,Hamilton,30,27,Peoples,30,27,3,3,3
2009-04-18,3,Herman,Loiseau,Herman,Unanimous,Hamilton,30,26,Leblanc,30,27,Paquette,30,27,4,3,3
2009-04-18,3,Grant,Chonan,Grant,Split,Hamilton,30,27,Paquette,29,28,Peoples,28,29,3,1,-1
2009-04-18,3,Marshall,Magalhães,Marshall,Unanimous,Leblanc,29,28,Paquette,30,27,Roussel,30,27,1,3,3
2009-04-17,3,Andrade,Stelly,Stelly,Unanimous,Atwood,27,29,Higdon,27,29,Lambert,26,30,-2,-2,-4
2009-04-17,3,Sanchez,Eduardo,Eduardo,Unanimous,Atwood,27,30,Higdon,27,30,Lambert,27,30,-3,-3,-3
2009-04-10,3,Reis,Martinez,Reis,Unanimous,Blatnick,30,27,Colón,30,27,Crosby,29,28,3,3,1
2009-04-10,3,Ortiz,Romero,Ortiz,Unanimous,Colón,29,28,Crosby,30,27,Rogers,30,27,1,3,3
2009-04-10,3,de la Cruz,Meza,de la Cruz,Unanimous,Blatnick,30,25,Colón,30,24,Crosby,30,24,5,6,6
2009-04-05,5,Torres,Mizugaki,Torres,Unanimous,Caldwell,49,46,D'Amato,48,47,White,49,46,3,1,3
2009-04-05,3,Benavidez,Curran,Benavidez,Unanimous,Hecko,30,27,Morley,29,28,Winter,30,27,3,1,3
2009-04-03,3,Payan,Palomino,Payan,Split,Bays,28,29,Gomez,29,28,Rupert,29,28,-1,1,1
2009-04-01,3,Condit,Kampmann,Kampmann,Split,Crosby,28,29,Hamilton,28,29,Peoples,29,28,-1,-1,1
2009-04-01,3,Bader,Marrero,Bader,Unanimous,Bertrand,30,27,Crosby,30,27,D'Amato,30,27,3,3,3
2009-04-01,3,dos Anjos,Griffin,Griffin,Unanimous,D'Amato,27,30,Hamilton,27,30,Peoples,27,30,-3,-3,-3
2009-03-07,3,Jackson,Jardine,Jackson,Unanimous,Crosby,29,28,Hamilton,29,28,Peoples,30,27,1,1,3
2009-03-07,3,Maynard,Miller,Maynard,Unanimous,Crosby,30,27,Hamilton,30,27,Mcgill,30,27,3,3,3
2009-03-07,3,Brilz,Boetsch,Brilz,Unanimous,Crosby,29,28,Franklin,29,28,Hamilton,29,28,1,1,1
2009-03-01,3,Palaszewski,Lamas,Lamas,Unanimous,Garcia,27,30,Rogers,27,30,Townsend,27,30,-3,-3,-3
2009-03-01,3,Hicks,McCullough,McCullough,Majority,Garcia,28,29,Rogers,29,29,Townsend,27,30,-1,0,-3
2009-03-01,3,Castillo,Cardella,Castillo,Split,Berrera,30,27,Rogers,29,28,Townsend,28,29,3,1,-1
2009-03-01,3,Hendricks,Serdyukov,Hendricks,Unanimous,Berrera,29,28,Garcia,29,28,Townsend,29,28,1,1,1
2009-03-01,3,Osawa,Rebello,Osawa,Split,Garcia,27,30,Rogers,29,28,Townsend,29,28,-3,1,1
2009-03-01,3,Franchi,Budnik,Franchi,Split,Berrera,29,28,Garcia,28,29,Rogers,29,28,1,-1,1
2009-02-21,3,Stevenson,Sanchez,Sanchez,Unanimous,Hughes,27,30,Lee,28,29,Roberts,27,30,-3,-1,-3
2009-02-21,3,Mandaloniz,Kelly,Kelly,Unanimous,Hughes,28,30,Lee,27,30,Sutherland,27,30,-2,-3,-3
2009-02-07,3,Bruno,Riddle,Riddle,Unanimous,Gomez,28,29,Green,28,29,Lee,28,29,-1,-1,-1
2009-01-31,3,Jones,Bonnar,Jones,Unanimous,Byrd,30,27,Peoples,29,28,Silbert,29,28,3,1,1
2009-01-31,3,Diaz,Guida,Guida,Split,Hamilton,28,29,Morse Jarman,29,28,Silbert,28,29,-1,1,-1
2009-01-31,3,Gono,Fitch,Fitch,Unanimous,Crosby,26,30,Peoples,27,30,Weeks,27,30,-4,-3,-3
2009-01-31,3,Tavares,Gamburyan,Tavares,Unanimous,Byrd,29,28,Hamilton,29,28,Rosales,29,28,1,1,1
2009-01-31,3,Wilson,Howard,Howard,Split,Morse Jarman,28,29,Peoples,29,28,Silbert,28,29,-1,1,-1
2009-01-31,3,O'Brien,Wellisch,O'Brien,Split,Hamilton,29,28,Peoples,29,28,Rosales,28,29,1,1,-1
2009-01-31,3,Cramer,Arroyo,Cramer,Split,Crosby,29,28,Morse Jarman,29,28,Silbert,28,29,1,1,-1
2009-01-25,5,Varner,Cerrone,Varner,Split,Bertrand,49,46,Hamilton,49,46,Rochin,47,48,3,3,-1
2009-01-17,3,Franklin,Henderson,Henderson,Split,Lee,28,29,Vannatta,28,29,Watts,30,27,-1,-1,3
2009-01-17,3,Palhares,Horn,Palhares,Unanimous,Bertrand,30,27,Vannatta,30,27,Watts,30,27,3,3,3
2009-01-17,3,Lytle,Davis,Davis,Split,Lee,28,29,Roberts,28,29,Vannatta,29,28,-1,-1,1
2008-12-27,3,Lister,Okami,Okami,Unanimous,Griffin,27,30,Rosales,27,30,Weeks,27,30,-3,-3,-3
2008-12-27,3,Chonan,Blackburn,Blackburn,Unanimous,Morse Jarman,28,29,Mullen,28,29,Rosales,28,29,-1,-1,-1
2008-12-13,3,Escudero,Nover,Escudero,Unanimous,Morse Jarman,29,28,Rosales,29,28,Trowbridge,29,28,1,1,1
2008-12-13,3,Kingsbury,Lawlor,Lawlor,Unanimous,Collins,28,29,Silbert,28,29,Trowbridge,28,29,-1,-1,-1
2008-12-13,3,Nelson,Roop,Nelson,Split,Byrd,29,28,Lefkowitz,28,29,Rosales,29,28,1,-1,1
2008-12-03,3,Martinez,Benavidez,Benavidez,Unanimous,Morse Jarman,27,30,Peoples,27,30,Trowbridge,27,30,-3,-3,-3
2008-12-03,3,Province,Nunes,Nunes,Unanimous,Morse Jarman,27,30,Peoples,28,29,Weeks,27,30,-3,-1,-3
2008-12-03,3,Takaya,Swanson,Swanson,Unanimous,Hamilton,27,30,Morse Jarman,28,29,Trowbridge,27,30,-3,-1,-3
2008-11-15,3,Riley,Gurgel,Riley,Unanimous,Collins,29,28,Morse Jarman,29,28,Peoples,29,28,1,1,1
2008-11-05,3,Sonnen,Filho,Sonnen,Unanimous,Lee,30,27,Rupert,30,27,Vannatta,30,27,3,3,3
2008-11-05,3,Cerrone,McCullough,Cerrone,Unanimous,Gomez,29,27,Lee,29,28,Vannatta,30,27,2,1,3
2008-10-25,3,Alves,Koscheck,Alves,Unanimous,Caldwell,30,27,Clancy,29,28,Goodman,30,27,3,1,3
2008-10-25,3,Maynard,Clementi,Maynard,Unanimous,Bilus,30,27,Hecko,30,27,Sabaitis,30,27,3,3,3
2008-10-25,3,Sherk,Griffin,Sherk,Unanimous,Bilus,30,27,Clancy,29,28,Hecko,29,28,3,1,1
2008-10-25,3,Horwich,Miller,Miller,Unanimous,Caldwell,28,29,Goodman,28,29,Hecko,28,29,-1,-1,-1
2008-10-25,3,Aurélio,Franca,Franca,Unanimous,Clancy,28,29,Rodriguez,28,29,Sabaitis,27,30,-1,-1,-3
2008-10-25,3,Burkman,Sell,Sell,Unanimous,Bilus,28,29,Caldwell,28,29,Hecko,28,29,-1,-1,-1
2008-10-18,3,Leben,Bisping,Bisping,Unanimous,Bertrand,27,30,Lee,27,30,Vannatta,28,29,-3,-3,-1
2008-10-18,3,Jardine,Vera,Jardine,Split,Lee,28,29,Vannatta,29,28,Watts,29,28,-1,1,1
2008-10-18,3,Taylor,Lytle,Lytle,Unanimous,Lee,28,29,Vannatta,27,30,Watts,28,29,-1,-3,-1
2008-10-18,3,Gono,Hardy,Hardy,Split,Lee,28,29,Roberts,28,29,Vannatta,29,28,-1,-1,1
2008-10-18,3,Liaudin,Bielkheden,Bielkheden,Unanimous,Bertrand,28,29,Lee,28,29,Watts,27,30,-1,-1,-3
2008-10-18,3,Etim,Stout,Etim,Unanimous,Bertrand,29,28,Roberts,30,27,Vannatta,29,28,1,3,1
2008-10-03,3,Vitale,Trigg,Trigg,Unanimous,Bates,27,30,Garcia,28,29,Van Tine,28,29,-3,-1,-1
2008-10-03,3,Evangelista,Caudillo,Evangelista,Unanimous,Bates,30,27,Garcia,29,28,Van Tine,29,28,3,1,1
2008-09-20,3,Ruiz,Prangley,Prangley,Unanimous,Hamilton,26,30,Peoples,27,30,Rosales,28,29,-4,-3,-1
2008-09-20,3,Magana,Thatch,Magana,Split,Hamilton,29,28,Peoples,29,28,Rosales,28,29,1,1,-1
2008-09-17,3,Neer,Diaz,Diaz,Split,Crosby,29,28,Mullen,28,29,Peoples,28,29,1,-1,-1
2008-09-17,3,Guida,Danzig,Guida,Unanimous,Crosby,30,27,Mullen,29,28,Peoples,29,28,3,1,1
2008-09-17,3,Belcher,Herman,Belcher,Unanimous,Crosby,29,28,Peoples,29,28,Sinnett,29,28,1,1,1
2008-09-06,3,Palhares,Henderson,Henderson,Unanimous,Crosby,27,30,Lee,28,29,Mullinax,27,30,-3,-1,-3
2008-09-06,3,Kim,Brown,Kim,Split,Crosby,29,28,Mullinax,29,28,Peoples,28,29,1,1,-1
2008-09-06,3,Pellegrino,Tavares,Pellegrino,Unanimous,Crosby,29,27,Lee,29,28,Mullinax,29,27,2,1,2
2008-09-06,3,Chonan,Carneiro,Chonan,Split,Crosby,29,28,Lee,28,29,Mullinax,29,28,1,-1,1
2008-08-09,5,St-Pierre,Fitch,St-Pierre,Unanimous,Crosby,50,43,Hamilton,50,44,Mullen,50,44,7,6,6
2008-08-09,3,Lesnar,Herring,Lesnar,Unanimous,Crosby,30,26,Mullen,30,26,Peoples,30,26,4,4,4
2008-08-09,3,Huerta,Florian,Florian,Unanimous,Crosby,27,30,Mullen,27,30,Peoples,27,30,-3,-3,-3
2008-08-09,3,Cummo,McCrory,McCrory,Unanimous,Gargiulo,28,29,Mullen,27,30,Peoples,27,30,-1,-3,-3
2008-08-09,3,Gusmão,Jones,Jones,Unanimous,Hamilton,27,30,Mullen,28,29,Peoples,27,30,-3,-1,-3
2008-08-09,3,Wilson,Bruno,Wilson,Unanimous,Crosby,30,27,Gargiulo,30,27,Mullen,30,27,3,3,3
2008-08-03,3,Osawa,Jorgensen,Jorgensen,Unanimous,Belardo,27,30,Hamilton,27,30,Lefkowitz,27,30,-3,-3,-3
2008-07-19,3,Vera,Andy,Vera,Unanimous,Byrd,30,27,Peoples,30,27,Trowbridge,29,28,3,3,1
2008-07-19,3,Edgar,Franca,Edgar,Unanimous,Morse Jarman,30,27,Mullen,30,27,Weeks,30,27,3,3,3
2008-07-05,5,Jackson,Griffin,Griffin,Unanimous,Byrd,46,48,Hamilton,46,48,Silbert,46,49,-2,-2,-3
2008-07-05,3,Almeida,Cote,Cote,Split,Morse Jarman,28,29,Trowbridge,29,28,Weeks,28,29,-1,1,-1
2008-07-05,3,Lytle,Koscheck,Koscheck,Unanimous,Byrd,26,30,Silbert,28,30,Weeks,27,29,-4,-2,-2
2008-07-05,3,Griffin,Aurélio,Griffin,Unanimous,Griffin,30,27,Morse Jarman,30,27,Trowbridge,30,27,3,3,3
2008-06-27,5,Melendez,Thomson,Thomson,Unanimous,Belardo,45,50,Hamilton,45,50,Peoples,45,50,-5,-5,-5
2008-06-27,3,Evangelista,Phan,Evangelista,Split,Belardo,29,28,Hamilton,28,29,Rosales,29,28,1,-1,1
2008-06-27,5,Ruiz,Southworth,Southworth,Unanimous,Hamilton,45,50,Peoples,46,49,Rosales,47,48,-5,-3,-1
2008-06-27,3,Maxwell,Tate,Tate,Unanimous,Belardo,28,29,Hamilton,28,29,Peoples,28,29,-1,-1,-1
2008-06-27,3,Palacios,Stack,Stack,Unanimous,Hamilton,28,29,Peoples,28,29,Rosales,28,29,-1,-1,-1
2008-06-21,3,Grove,Tanner,Grove,Split,Lefkowitz,28,29,Rosales,30,26,Trowbridge,30,26,-1,4,4
2008-06-21,3,Fisher,Stephens,Fisher,Unanimous,Morse Jarman,29,28,Rosales,29,28,Trowbridge,29,28,1,1,1
2008-06-21,3,Rivera,Riddle,Riddle,Unanimous,Lefkowitz,27,30,Peoples,28,29,Weeks,27,30,-3,-1,-3
2008-06-07,3,Swick,Davis,Swick,Unanimous,Hamilton,29,27,Mullen,29,27,Roberts,29,27,2,2,2
2008-06-07,3,Marquardt,Leites,Leites,Split,Hamilton,27,28,Peoples,27,28,Watts,28,27,-1,-1,1
2008-06-07,3,Taylor,Liaudin,Taylor,Split,Foley,28,29,Mullen,29,28,Roberts,29,28,-1,1,1
2008-06-01,5,Pulver,Faber,Faber,Unanimous,Bertrand,44,50,Hamilton,45,50,Rosales,44,50,-6,-5,-6
2008-06-01,3,Alexander,McCullough,McCullough,Split,Hamilton,29,28,Rosales,27,30,Weeks,27,30,1,-3,-3
2008-06-01,3,Brown,Curran,Brown,Unanimous,Bertrand,30,27,Rosales,30,27,Weeks,30,27,3,3,3
2008-06-01,3,Beebe,Ribeiro,Ribeiro,Split,Hamilton,28,29,Rosales,29,28,Weeks,28,29,-1,1,-1
2008-06-01,3,Cruz,Valencia,Cruz,Unanimous,Bertrand,29,28,Hamilton,29,28,Weeks,30,27,1,1,3
2008-05-24,3,Ortiz,Machida,Machida,Unanimous,Crosby,27,30,Trowbridge,27,30,Weeks,27,30,-3,-3,-3
2008-05-24,3,Clementi,Etim,Clementi,Unanimous,Byrd,29,28,Lebell,29,28,Weeks,29,28,1,1,1
2008-04-19,3,Quarry,Starnes,Quarry,Unanimous,Crosby,30,26,Hamilton,30,27,Procopio,30,24,4,3,6
2008-04-19,3,Stout,Clementi,Clementi,Split,Crosby,27,29,Leblanc,29,28,Procopio,28,29,-2,1,-1
2008-04-02,3,Maynard,Edgar,Maynard,Unanimous,Peoples,30,27,Van Tine,30,27,Weeks,30,27,3,3,3
2008-04-02,3,Thomas,Neer,Neer,Unanimous,Garcia,27,30,Hamilton,27,30,Peoples,27,30,-3,-3,-3
2008-03-26,3,Sonnen,Baker,Sonnen,Unanimous,Hamilton,30,25,Lebell,30,25,Weeks,30,26,5,5,4
2008-03-26,3,Crunkilton,Gomez,Crunkilton,Unanimous,Hamilton,30,27,Lebell,30,26,Lefkowitz,29,28,3,4,1
2008-03-26,3,Manuel,Osawa,draw,Split,Belardo,28,29,Byrd,29,28,Lefkowitz,28,28,-1,1,0
2008-03-15,12,Pacquiao,Márquez,Pacquiao,Split,Ford,115,112,Miller,114,113,Roth,112,115,3,1,-3
2008-03-01,3,Kongo,Herring,Herring,Split,Agosta,28,29,Hamilton,28,29,Peoples,29,28,-1,-1,1
2008-03-01,3,Fitch,Wilson,Fitch,Unanimous,Hamilton,29,28,Peoples,30,27,Ventresca,30,27,1,3,3
2008-03-01,3,Fioravanti,Cummo,Fioravanti,Unanimous,Hamilton,30,27,Mullen,30,27,Ventresca,30,27,3,3,3
2008-03-01,3,Gurgel,Halverson,Gurgel,Unanimous,Agosta,29,28,Hamilton,30,27,Mullen,29,28,1,3,1
2008-02-23,3,Berger,Ellis,Ellis,Unanimous,Corley,28,29,Dickson,28,29,Restad,27,30,-1,-1,-3
2008-02-23,3,Healy,Masvidal,Masvidal,Unanimous,Corley,27,30,Dickson,27,30,Silbert,27,30,-3,-3,-3
2008-02-23,3,Kovacs,Hayes,Hayes,Unanimous,Corley,27,30,Dickson,27,30,Restad,28,29,-3,-3,-1
2008-02-23,3,Skinner,Shaffer,Skinner,Unanimous,Corley,29,28,Dickson,29,28,Silbert,29,28,1,1,1
2008-02-13,3,Banuelos,Tapia,Tapia,Split,King,28,29,Peoples,29,28,Romero,27,30,-1,1,-3
2008-02-13,3,Jorgensen,Page,Page,Unanimous,King,28,29,Porrata,27,30,Romero,28,29,-1,-3,-1
2008-02-02,3,Tibau,Griffin,Griffin,Unanimous,Byrd,27,30,Collins,27,30,Weeks,27,30,-3,-3,-3
2008-02-02,3,Eastman,Martin,Eastman,Unanimous,Hamilton,30,27,Morse Jarman,30,27,Trowbridge,29,28,3,3,1
2008-02-02,3,Emerson,Nakamura,Emerson,Split,Byrd,30,27,Collins,28,29,Lefkowitz,30,27,3,-1,3
2008-01-23,3,Swick,Burkman,Swick,Majority,Byrd,29,28,Hamilton,29,29,Trowbridge,29,28,1,0,1
2008-01-23,3,Tavares,Omigawa,Tavares,Unanimous,Griffin,29,28,Morse Jarman,30,27,Trowbridge,30,27,1,3,3
2008-01-23,3,Siver,Maynard,Maynard,Unanimous,Griffin,28,29,Hamilton,27,30,Morse Jarman,28,29,-1,-3,-1
2008-01-19,3,Taylor,Kelly,Kelly,Unanimous,Mullen,27,30,Watts,27,30,Weeks,27,30,-3,-3,-3
2008-01-19,3,Stout,Eklund,Stout,Unanimous,Crosby,29,27,Watts,30,27,Weeks,30,27,2,3,3
2007-12-29,3,Liddell,Silva,Liddell,Unanimous,Byrd,30,27,Hagen,30,27,Weeks,29,28,3,3,1
2007-12-29,3,Radev,Lister,Lister,Unanimous,Byrd,27,30,Hagen,27,30,Morse Jarman,27,30,-3,-3,-3
2007-12-29,3,Evans,Bocek,Bocek,Unanimous,Byrd,28,29,Mullen,28,29,Trowbridge,28,29,-1,-1,-1
2007-12-12,3,Moore,Alessio,Alessio,Unanimous,Byrd,27,30,Lefkowitz,27,30,Trowbridge,27,30,-3,-3,-3
2007-12-12,3,Schambari,Baker,Baker,Split,Collins,27,30,Morse Jarman,29,28,Weeks,28,29,-3,1,-1
2007-12-08,3,Barrera,Saunders,Saunders,Unanimous,D'Amato,27,30,Lefkowitz,28,29,Weeks,27,30,-3,-1,-3
2007-11-17,3,Bisping,Evans,Evans,Split,Bittencourt,29,28,Colón,28,29,Crosby,28,29,1,-1,-1
2007-11-17,3,Chonan,Parisyan,Parisyan,Unanimous,Bittencourt,27,30,Colón,27,30,Crosby,27,30,-3,-3,-3
2007-11-17,3,Fisher,Edgar,Edgar,Unanimous,Bittencourt,27,30,Colón,27,30,Crosby,26,30,-3,-3,-4
2007-11-16,3,Schwartz,Davis,Davis,Unanimous,Hamilton,28,29,Peoples,28,29,Rosales,28,29,-1,-1,-1
2007-10-20,3,Vera,Sylvia,Sylvia,Unanimous,Barry,27,29,Crosby,28,29,Mullen,28,29,-2,-1,-1
2007-10-20,3,Gurgel,Robinson,Robinson,Unanimous,Hamilton,27,29,Kloock,28,29,Mullen,27,29,-2,-1,-2
2007-10-20,3,Okami,MacDonald,Okami,Unanimous,Barry,30,27,Hamilton,30,27,Mullen,30,27,3,3,3
2007-10-20,3,Black,Grice,Grice,Split,Hamilton,28,29,Kloock,29,28,Mullen,28,29,-1,1,-1
2007-09-29,3,Kato,Melendez,Melendez,Unanimous,Belardo,27,30,Cobian,27,30,Peoples,27,30,-3,-3,-3
2007-09-29,3,Coronel,Evangelista,Evangelista,Split,Belardo,27,30,Cobian,28,29,Peoples,29,28,-3,-1,1
2007-09-29,3,Puder,Dalton,Puder,Unanimous,Belardo,30,27,Cobian,30,27,Rosales,30,27,3,3,3
2007-09-29,3,Smith,Cooper,Cooper,Unanimous,Belardo,28,29,Cobian,27,29,Hamilton,28,29,-1,-2,-1
2007-09-22,3,Liddell,Jardine,Jardine,Split,Bertrand,28,29,Peoples,28,29,Rosales,29,28,-1,-1,1
2007-09-22,3,Fitch,Sanchez,Fitch,Split,Bertrand,29,28,Peoples,30,27,Rosales,28,29,1,3,-1
2007-09-22,3,Nakamura,Machida,Machida,Unanimous,Bertrand,27,30,Peoples,27,30,Rosales,27,30,-3,-3,-3
2007-09-22,3,Griffin,Tavares,Griffin,Unanimous,Bertrand,29,28,Peoples,30,27,Rosales,29,28,1,3,1
2007-09-19,3,Miller,Garcia,Miller,Unanimous,Lefkowitz,29,28,Rosales,30,27,Trowbridge,30,27,1,3,3
2007-09-08,5,Henderson,Jackson,Jackson,Unanimous,Crosby,47,48,Peoples,46,49,Roberts,46,49,-1,-3,-3
2007-09-08,3,Bisping,Hamill,Bisping,Split,Mullen,29,28,Peoples,29,28,Watts,27,30,1,1,-3
2007-09-08,3,Kongo,Filipovic,Kongo,Unanimous,Mullen,29,28,Peoples,29,28,Roberts,29,28,1,1,1
2007-09-08,3,Tibau,Etim,Tibau,Unanimous,Crosby,30,27,Mullen,30,27,Roberts,30,27,3,3,3
2007-09-05,5,Yahya,Beebe,Beebe,Unanimous,Belardo,46,49,Lee,45,49,Peoples,46,49,-3,-4,-3
2007-09-05,3,Alessio,Brito,Alessio,Unanimous,Belardo,30,27,Morse Jarman,30,27,Peoples,30,27,3,3,3
2007-08-25,3,Koscheck,St-Pierre,St-Pierre,Unanimous,Byrd,28,29,Collins,28,29,Trowbridge,27,30,-1,-1,-3
2007-08-25,3,Stevenson,Pellegrino,Stevenson,Unanimous,Crosby,30,27,Lebell,30,27,Peoples,29,28,3,3,1
2007-08-25,3,Guida,Aurélio,Guida,Split,Byrd,28,29,Collins,30,27,Morse Jarman,30,27,-1,3,3
2007-08-05,3,Curran,Ledbetter,Curran,Unanimous,Griffin,30,27,Lefkowitz,29,28,Weeks,29,28,3,1,1
2007-08-05,3,Robbins,Banuelos,Banuelos,Unanimous,Byrd,27,30,Griffin,27,30,Lefkowitz,26,30,-3,-3,-4
2007-08-05,3,Clark,Schambari,Schambari,Unanimous,Morse Jarman,28,29,Silbert,28,29,Trowbridge,28,29,-1,-1,-1
2007-07-07,5,Franca,Sherk,Sherk,Unanimous,Bertrand,45,50,Hamilton,45,50,Peoples,46,49,-5,-5,-3
2007-07-07,3,Nogueira,Herring,Nogueira,Unanimous,Hamilton,29,28,Peoples,29,28,Rochin,29,28,1,1,1
2007-07-07,3,Gurgel,Saraiva,Gurgel,Unanimous,Bertrand,30,27,Hamilton,30,27,Rochin,30,27,3,3,3
2007-07-07,3,Ortiz,Evans,draw,Unanimous,Bertrand,28,28,Hamilton,28,28,Peoples,28,28,0,0,0
2007-06-22,3,Pyle,Wetherspoon,Pyle,Unanimous,Bertrand,29,27,Hamilton,30,27,Rosales,30,27,2,3,3
2007-06-22,3,Cariaso,Figueroa,Cariaso,Unanimous,Hamilton,30,27,Peoples,30,27,Rosales,29,28,3,3,1
2007-06-16,3,Franklin,Okami,Franklin,Unanimous,Crosby,29,28,Mullen,29,28,Roberts,29,28,1,1,1
2007-06-16,3,Ramirez,Griffin,Griffin,Unanimous,Mullen,27,30,Roberts,27,30,Watts,27,30,-3,-3,-3
2007-06-16,3,Griffin,Guida,Griffin,Split,Crosby,29,28,Mullen,28,29,Roberts,29,28,1,-1,1
2007-06-12,3,Stout,Fisher,Fisher,Unanimous,Lee,27,30,Ross,27,30,Vannatta,27,30,-3,-3,-3
2007-06-12,3,Petz,Fioravanti,Petz,Unanimous,Gomez,29,28,Ross,29,28,Vannatta,30,27,1,1,3
2007-06-12,3,Caudillo,Mohr,Mohr,Unanimous,Mullen,28,29,Ross,27,30,Vannatta,28,29,-1,-3,-1
2007-06-03,3,Karalexis,Smith,Karalexis,Majority,Belardo,29,27,Hagen,28,28,Silbert,29,27,2,0,2
2007-06-03,3,Miller,Swanson,Swanson,Unanimous,Byrd,27,30,Collins,27,30,Hamilton,27,30,-3,-3,-3
2007-06-03,3,French,Bedard,Bedard,Unanimous,Hagen,27,30,Silbert,27,30,Weeks,27,30,-3,-3,-3
2007-05-26,3,Parisyan,Burkman,Parisyan,Unanimous,Griffin,29,28,Mullen,30,27,Weeks,30,27,1,3,3
2007-05-26,3,Leben,Starnes,Starnes,Unanimous,Collins,28,29,Lee,27,30,Morse Jarman,28,29,-1,-3,-1
2007-05-12,3,Miura,Miller,Miller,Unanimous,Lefkowitz,28,29,Silbert,28,29,Weeks,28,29,-1,-1,-1
2007-05-12,3,Gandulla,Padilla,Gandulla,Split,Byrd,28,29,D'Amato,29,28,Morse Jarman,29,28,-1,1,1
2007-05-12,3,Schambari,Santore,Schambari,Unanimous,Morse Jarman,29,28,Silbert,30,27,Weeks,30,27,1,3,3
2007-05-05,12,De La Hoya,Mayweather,Mayweather,Split,Giampa,112,116,Kaczmarek,115,113,Roth,113,115,-4,2,-2
2007-04-21,3,Werdum,Arlovski,Arlovski,Unanimous,Crosby,27,30,Mullen,27,30,Peoples,27,30,-3,-3,-3
2007-04-21,3,Heath,Machida,Machida,Unanimous,Crosby,27,30,Peoples,26,30,Roberts,27,30,-3,-4,-3
2007-04-21,3,Silva,Kongo,Kongo,Majority,Crosby,28,28,Mullen,28,29,Watts,28,29,0,-1,-1
2007-04-07,3,Sanchez,Koscheck,Koscheck,Unanimous,Crosby,27,30,Hamilton,27,30,Mullen,27,30,-3,-3,-3
2007-04-07,3,Garcia,Huerta,Huerta,Unanimous,Crosby,27,30,Hamilton,27,30,Mullen,27,30,-3,-3,-3
2007-04-07,3,Okami,Swick,Okami,Unanimous,Crosby,30,27,Hamilton,29,28,Mullen,29,28,3,1,1
2007-04-07,3,Herring,Imes,Herring,Unanimous,Bish,30,27,Crosby,29,28,Van Hoy,30,25,3,1,5
2007-04-07,3,Leites,Sell,Leites,Unanimous,Alvarez,30,27,Bish,30,27,Van Hoy,30,26,3,3,4
2007-04-05,3,McCully,Hardonk,McCully,Unanimous,Byrd,30,27,Griffin,30,27,Trowbridge,30,27,3,3,3
2007-04-05,3,Nakamura,Fickett,Fickett,Unanimous,Griffin,26,30,Lee,27,29,Trowbridge,27,29,-4,-2,-2
2007-04-05,3,Petz,Hironaka,Hironaka,Unanimous,Byrd,28,29,Crosby,27,30,Trowbridge,27,30,-1,-3,-3
2007-04-05,3,Clementi,Carneiro,Carneiro,Unanimous,Griffin,27,30,Lee,27,30,Mullen,27,30,-3,-3,-3
2007-04-05,3,Kotani,Tavares,Tavares,Unanimous,Crosby,27,30,Lebell,27,30,Weeks,27,30,-3,-3,-3
2007-03-24,5,Wineland,Beebe,Beebe,Unanimous,Byrd,46,48,Hamilton,46,48,Trowbridge,47,48,-2,-2,-1
2007-03-03,5,Couture,Sylvia,Couture,Unanimous,Crosby,50,45,Hamilton,50,45,Peoples,50,45,5,5,5
2007-03-03,3,Tibau,Dent,Tibau,Unanimous,Crosby,30,27,Kalikas,30,27,Peoples,30,27,3,3,3
2007-02-03,3,Cote,Smith,Cote,Unanimous,Rosales,30,27,Trowbridge,30,27,Weeks,29,28,3,3,1
2007-02-03,3,Edgar,Griffin,Edgar,Unanimous,Hagen,29,28,Trowbridge,30,27,Weeks,29,28,1,3,1
2007-02-03,3,Hoger,Machida,Machida,Unanimous,Lee,27,30,Peoples,27,30,Rosales,27,30,-3,-3,-3
2007-02-03,3,Saraiva,Hazelett,Hazelett,Unanimous,Hagen,27,30,Rosales,27,30,Weeks,27,30,-3,-3,-3
2007-01-25,3,O'Brien,Herring,O'Brien,Unanimous,Mullen,30,27,Trematerra,30,27,Vannatta,29,28,3,3,1
2007-01-25,3,Marquardt,Lister,Marquardt,Unanimous,Gomez,30,25,Lee,30,27,Trematerra,30,25,5,3,5
2007-01-25,3,Burkman,Reiner,Burkman,Unanimous,Mullen,29,28,Trematerra,29,28,Vannatta,30,27,1,1,3
2007-01-25,3,Guida,Thomas,Thomas,Unanimous,Gomez,28,29,Mullen,28,29,Trematerra,28,29,-1,-1,-1
2007-01-20,3,Gonzalez,Seguin,Seguin,Unanimous,Collins,27,30,Hagen,27,30,Morse Jarman,27,30,-3,-3,-3
2007-01-20,3,French,Banuelos,Banuelos,Unanimous,Hagen,26,30,Lefkowitz,27,30,Peoples,27,30,-4,-3,-3
2006-12-30,3,Perosh,Wellisch,Wellisch,Unanimous,Griffin,28,29,Mullen,27,29,Rosales,28,29,-1,-2,-1
2006-12-13,3,Joslin,Koscheck,Koscheck,Unanimous,Bertrand,27,30,Peoples,27,30,Rochin,27,30,-3,-3,-3
2006-12-13,3,Parisyan,Fickett,Parisyan,Unanimous,Hamilton,30,27,Peoples,30,27,Rochin,30,27,3,3,3
2006-12-13,3,Davis,Carter,Davis,Unanimous,Bertrand,30,26,Hamilton,30,27,Rochin,29,28,4,3,1
2006-12-13,3,Valimaki,Heath,Heath,Split,Hamilton,28,29,Peoples,29,28,Rochin,28,29,-1,1,-1
2006-12-13,3,Nakamura,Larson,Larson,Unanimous,Bertrand,28,29,Peoples,28,29,Rochin,28,29,-1,-1,-1
2006-12-08,5,Southworth,White,Southworth,Unanimous,Hamilton,49,46,Rosales,50,45,Stell,50,46,3,5,4
2006-12-08,3,Barrios,Figueroa,Figueroa,Unanimous,Hamilton,27,30,Rosales,28,29,Stell,28,29,-3,-1,-1
2006-11-18,5,Sylvia,Monson,Sylvia,Unanimous,Bertrand,49,46,Hernandez,50,45,Rochin,49,46,3,5,3
2006-11-11,3,Serra,Lytle,Serra,Split,Griffin,30,27,Rosales,30,27,Trowbridge,27,30,3,3,-3
2006-11-11,3,Leites,Kampmann,Kampmann,Unanimous,Byrd,27,29,Rosales,28,29,Trowbridge,27,29,-2,-1,-2
2006-10-14,5,Sherk,Florian,Sherk,Unanimous,Mullen,49,46,Peoples,50,45,Weeks,49,46,3,5,3
2006-10-14,3,Fitch,Hironaka,Fitch,Unanimous,Belardo,30,25,Griffin,30,27,Trowbridge,30,27,5,3,3
2006-10-14,3,Kongo,Marrero,Marrero,Split,Griffin,28,29,Hamilton,28,29,Weeks,29,28,-1,-1,1
2006-10-10,3,Hamill,Petruzelli,Hamill,Unanimous,Mullen,30,27,Ross,29,28,Vannatta,29,28,3,1,1
2006-10-10,3,Singer,Haynes,Singer,Unanimous,Mullen,29,28,Ross,29,28,Trematerra,29,28,1,1,1
2006-10-10,3,Alves,Alessio,Alves,Unanimous,Pernick,30,27,Ross,30,27,Vannatta,30,27,3,3,3
2006-09-23,3,Swick,Loiseau,Swick,Unanimous,Bertrand,29,28,Hamilton,29,28,Rochin,29,28,1,1,1
2006-09-23,3,Gurgel,Abbadi,Gurgel,Unanimous,Hamilton,29,28,Peoples,29,28,Rochin,29,28,1,1,1
2006-08-26,3,Bonnar,Griffin,Griffin,Unanimous,Hamilton,27,30,Peoples,27,30,Trowbridge,27,30,-3,-3,-3
2006-08-26,3,Okami,Belcher,Okami,Unanimous,Byrd,29,28,Griffin,30,27,Peoples,30,27,1,3,3
2006-08-17,3,Sanchez,Parisyan,Sanchez,Unanimous,Hamilton,29,28,Rosales,29,28,Trowbridge,30,26,1,1,4
2006-08-17,3,Sasaki,Lister,Lister,Unanimous,Belardo,27,30,Hamilton,27,30,Rosales,27,30,-3,-3,-3
2006-08-17,3,Petz,Morgan,Petz,Unanimous,Byrd,30,27,Hamilton,30,26,Rosales,30,23,3,4,7
2006-07-08,5,Arlovski,Sylvia,Sylvia,Unanimous,Hagen,46,49,Hamilton,47,48,Trowbridge,47,48,-3,-1,-1
2006-07-08,3,Burkman,Neer,Burkman,Unanimous,Belardo,29,28,Lee,30,27,Weeks,29,28,1,3,1
2006-07-08,3,Mir,Christison,Mir,Unanimous,Belardo,29,28,Byrd,29,28,Trowbridge,29,28,1,1,1
2006-06-28,3,Cummo,Goulet,Goulet,Majority,Hagen,27,30,Porrata,29,29,Trowbridge,27,30,-3,0,-3
2006-06-28,3,Evans,Bonnar,Evans,Majority,Hamilton,30,27,Peoples,29,28,Shirley,29,29,3,1,0
2006-06-28,3,Hominick,Gurgel,Hominick,Unanimous,Byrd,29,28,Hagen,29,28,Trowbridge,29,28,1,1,1
2006-06-28,3,Koscheck,Menne,Koscheck,Unanimous,Hamilton,30,27,Porrata,29,28,Shirley,30,27,3,1,3
2006-06-24,3,Herman,Grove,Grove,Unanimous,Griffin,28,29,Mullen,28,29,Rosales,28,29,-1,-1,-1
2006-06-24,3,Jardine,Gouveia,Jardine,Unanimous,Griffin,29,28,Hamilton,29,28,Trowbridge,29,28,1,1,1
2006-06-09,3,Overeem,Belfort,Overeem,Unanimous,Morrow,29,28,Stell,29,28,Thomas-Gitlin,30,27,1,1,3
2006-06-09,5,Melendez,Guida,Melendez,Split,Morrow,50,45,Schorle,46,48,Thomas-Gitlin,50,45,5,-2,5
2006-05-27,3,Sanchez,Alessio,Sanchez,Unanimous,Bertrand,30,27,Peoples,29,28,Rochin,29,28,3,1,1
2006-04-15,3,Diaz,Sherk,Sherk,Unanimous,Belardo,27,30,Peoples,27,30,Rochin,27,30,-3,-3,-3
2006-04-15,3,Ortiz,Griffin,Ortiz,Split,Belardo,30,27,Hernandez,28,29,Peoples,29,27,3,-1,2
2006-04-15,3,Cruz,Monson,Monson,Split,Belardo,27,30,Hernandez,28,29,Rochin,29,28,-3,-1,1
2006-04-08,12,Mayweather,Judah,Mayweather,Unanimous,Hamada,119,109,Moretti,116,112,Roth,117,111,10,4,6
2006-04-06,3,Bonnar,Jardine,Bonnar,Unanimous,Belardo,29,28,Hamilton,29,28,Peoples,29,28,1,1,1
2006-04-06,3,Evans,Hoger,Evans,Split,Porrata,28,29,Rosales,30,27,Trowbridge,29,28,-1,3,1
2006-04-06,3,Neer,Stevenson,Neer,Unanimous,Belardo,29,28,Hagen,29,28,Hamilton,29,28,1,1,1
2006-04-06,3,Fioravanti,Leben,Leben,Unanimous,Peoples,27,30,Porrata,27,30,Rosales,27,30,-3,-3,-3
2006-04-06,3,Von Flue,Cummo,Cummo,Unanimous,Belardo,27,30,Hagen,26,30,Trowbridge,27,30,-3,-4,-3
2006-04-06,3,Sonnen,Prangley,Sonnen,Unanimous,Hamilton,30,27,Peoples,30,27,Rosales,30,27,3,3,3
2006-03-10,5,Guida,Thomson,Guida,Unanimous,Hernandez,49,46,Mcknight,49,45,Rochin,49,45,3,4,4
2006-03-10,3,Horwich,Ebersole,Ebersole,Unanimous,Belardo,27,30,Hernandez,28,29,Rochin,27,30,-3,-1,-3
2006-03-04,5,Franklin,Loiseau,Franklin,Unanimous,Hamilton,50,43,Mullen,50,43,Shirley,50,42,7,7,8
2006-03-04,3,Penn,St-Pierre,St-Pierre,Split,Hamilton,28,29,Peoples,29,28,Rosales,28,29,-1,1,-1
2006-03-04,3,Marquardt,Doerksen,Marquardt,Unanimous,Griffin,30,27,Rosales,30,27,Trowbridge,30,27,3,3,3
2006-03-04,3,Fisher,Stout,Stout,Split,Griffin,28,29,Peoples,28,29,Trowbridge,29,28,-1,-1,1
2006-02-04,3,Diaz,Riggs,Riggs,Unanimous,Belardo,28,29,Trowbridge,28,29,Weeks,27,30,-1,-1,-3
2006-02-04,3,Sakara,Sinosic,Sakara,Unanimous,Belardo,29,25,Mullen,29,26,Peoples,29,26,4,3,3
2006-02-04,3,Whitehead,Jardine,Jardine,Unanimous,Hamilton,28,29,Peoples,28,29,Shirley,28,29,-1,-1,-1
2006-01-16,3,Sylvia,Silva,Sylvia,Unanimous,Byrd,30,27,Peoples,30,27,Shirley,29,28,3,3,1
2005-11-19,3,Horn,Prangley,Horn,Unanimous,Hamilton,29,28,Rosales,29,28,Trowbridge,29,28,1,1,1
2005-11-19,3,Wisniewski,Thompson,Thompson,Unanimous,Hamilton,27,30,Mullen,27,30,Peoples,27,30,-3,-3,-3
2005-11-05,3,Sanchez,Diaz,Sanchez,Unanimous,Hamilton,30,27,Peoples,30,27,Rosales,30,27,3,3,3
2005-11-05,3,Evans,Imes,Evans,Split,Belardo,29,28,Hamilton,29,28,Weeks,28,29,1,1,-1
2005-11-05,3,Stevenson,Cummo,Stevenson,Unanimous,Peoples,29,28,Rosales,30,27,Trowbridge,29,28,1,3,1
2005-10-03,3,Larson,Fitch,Fitch,Unanimous,Hamilton,27,30,Mullen,27,30,Peoples,27,30,-3,-3,-3
2005-08-20,3,Lindland,Doerksen,Lindland,Unanimous,Hamilton,30,27,Mullen,29,28,Trowbridge,30,27,3,1,3
2005-08-20,3,Lutter,Prangley,Prangley,Unanimous,Peoples,27,30,Shirley,27,30,Weeks,26,30,-3,-3,-4
2005-08-06,3,Salaverry,Marquardt,Marquardt,Unanimous,Mullen,27,30,Schorle,27,30,Trowbridge,28,29,-3,-3,-1
2005-08-06,3,Leben,Cote,Leben,Split,Schorle,29,28,Shirley,30,27,Silbert,27,29,1,3,-2
2005-08-06,3,Hoger,Bonnar,Bonnar,Unanimous,Mullen,27,30,Schorle,27,30,Trowbridge,27,30,-3,-3,-3
2005-06-04,3,Parisyan,Serra,Parisyan,Unanimous,Belardo,30,27,Crosby,30,27,Mullen,29,28,3,3,1
2005-04-16,3,Miller,St-Pierre,St-Pierre,Unanimous,Peoples,27,30,Rosales,27,30,Shirley,27,30,-3,-3,-3
2005-04-16,3,Marsh,Van Arsdale,Van Arsdale,Unanimous,Peoples,28,29,Rosales,28,29,Shirley,28,29,-1,-1,-1
2005-04-09,3,Griffin,Bonnar,Griffin,Unanimous,Mullen,29,28,Shirley,29,28,Weeks,29,28,1,1,1
2005-04-09,3,Hoger,Southworth,Hoger,Unanimous,Mullen,29,28,Trowbridge,30,28,Weeks,29,28,1,2,1
2005-03-19,12,Pacquiao,Morales,Morales,Unanimous,Giampa,113,115,Moretti,113,115,Smith,113,115,-2,-2,-2
2005-02-05,3,Ortiz,Belfort,Ortiz,Split,Hamilton,29,28,Mullen,28,29,Peoples,29,28,1,-1,1
2005-02-05,3,Parisyan,Lytle,Parisyan,Unanimous,Mullen,30,27,Peoples,30,27,Shirley,30,27,3,3,3
2004-10-22,3,Cote,Ortiz,Ortiz,Unanimous,Belardo,27,30,Mullen,26,30,Peoples,26,30,-3,-4,-4
2004-08-21,3,Diaz,Parisyan,Parisyan,Split,Peoples,28,29,Rosales,27,30,Shirley,29,28,-1,-3,1
2004-06-19,3,Hughes,Verissimo,Hughes,Unanimous,Belardo,30,27,Hamilton,29,28,Shirley,30,27,3,1,3
2004-06-19,3,Baroni,Tanner,Tanner,Unanimous,Peoples,27,30,Rosales,27,30,Shirley,28,29,-3,-3,-1
2004-06-19,3,Serra,Menjivar,Serra,Unanimous,Belardo,30,27,Hamilton,30,27,Trowbridge,30,27,3,3,3
2004-04-02,3,Franca,Edwards,Edwards,Split,Peoples,28,29,Shirley,28,29,Weeks,29,28,-1,-1,1
2004-01-31,3,Verissimo,Newton,Verissimo,Unanimous,Hamilton,30,27,Rosales,30,27,Trowbridge,30,27,3,3,3
2004-01-31,3,Parisyan,St-Pierre,St-Pierre,Unanimous,Hamilton,28,29,Rosales,27,30,Trowbridge,27,30,-1,-3,-3
2004-01-31,3,Franca,Thomson,Thomson,Unanimous,Belardo,28,29,Rosales,28,29,Trowbridge,28,29,-1,-1,-1
2004-01-31,3,Curran,Serra,Serra,Unanimous,Hamilton,27,30,Peoples,27,30,Shirley,27,30,-3,-3,-3
2003-11-21,3,Lytle,Lawler,Lawler,Unanimous,Crosby,28,29,Mullen,28,29,Peoples,28,29,-1,-1,-1
2003-11-21,3,Rizzo,Rodriguez,Rizzo,Unanimous,Crosby,30,27,Hamilton,29,28,Mullen,30,27,3,1,3
2003-09-26,5,Ortiz,Couture,Couture,Unanimous,Hamilton,44,50,Mullen,44,50,Rosales,45,50,-6,-6,-5
2003-09-26,3,Rivera,Loiseau,Rivera,Unanimous,Hamilton,29,28,Peoples,29,27,Weeks,29,28,1,2,1
2003-06-06,3,Edwards,Ruiz,Edwards,Unanimous,Belardo,30,27,Peoples,30,27,Rosales,30,27,3,3,3
2003-06-06,3,White,Freeman,draw,Split,Belardo,28,29,Peoples,30,27,Weeks,29,29,-1,3,0
2003-04-25,5,Sherk,Hughes,Hughes,Unanimous,Crosby,46,49,Millis,47,48,Mullen,45,48,-3,-1,-3
2003-04-25,3,Aram,Strasser,Strasser,Unanimous,Crosby,27,30,Mullen,27,30,Peoples,27,30,-3,-3,-3
2003-04-25,3,Ludwig,Sudo,Ludwig,Unanimous,Crosby,29,28,Mullen,29,28,Peoples,29,28,1,1,1
2003-04-25,3,Franca,Crunkilton,Franca,Unanimous,Crosby,29,28,Millis,29,28,Peoples,29,28,1,1,1
2003-02-28,3,Lindland,Baroni,Lindland,Unanimous,Hamilton,29,28,Mullinax,29,28,Wright,29,28,1,1,1
2003-02-28,3,Rizzo,Matyushenko,Matyushenko,Unanimous,Crosby,28,29,Hamilton,27,30,Mullinax,28,29,-1,-3,-1
2003-02-28,5,Uno,Penn,draw,Split,Crosby,46,48,Mullinax,48,47,Wright,48,48,-2,1,0
2002-09-27,3,Penn,Serra,Penn,Unanimous,Crosby,29,28,Mullen,29,28,Peoples,29,28,1,1,1
2002-09-27,3,Uno,Thomas,Uno,Unanimous,Hamilton,29,27,Mullen,29,27,Peoples,29,27,2,2,2
2002-09-27,3,Lindland,Salaverry,Lindland,Unanimous,Crosby,30,28,Mullen,29,28,Peoples,29,28,2,1,1
2002-07-13,3,Miller,Zikic,Miller,Unanimous,Hamilton,29,28,Mullen,29,28,Peoples,29,28,1,1,1
2002-07-13,3,Sobral,Sinosic,Sobral,Unanimous,Hamilton,30,27,Mullen,30,27,Peoples,30,26,3,3,4
2002-07-13,3,Tanner,Haseman,Tanner,Unanimous,Mullen,30,26,Peoples,30,26,Watts,30,27,4,4,3
2002-06-22,3,Liddell,Belfort,Liddell,Unanimous,Belardo,30,27,Peoples,30,27,Rosales,29,28,3,3,1
2002-06-22,3,Radach,Serra,Radach,Unanimous,Belardo,30,27,Millis,29,28,Weeks,30,27,3,1,3
2002-05-10,3,Uno,Edwards,Uno,Unanimous,Mullen,29,28,Peoples,30,29,Rosales,29,28,1,1,1
2002-05-10,3,Riley,Lawler,Lawler,Unanimous,Hamilton,28,29,Mullen,27,29,Rosales,27,29,-1,-2,-2
2002-03-22,3,Nakao,Sherk,Sherk,Unanimous,Crosby,27,30,Peoples,27,30,Rosales,27,30,-3,-3,-3
2002-01-11,5,Penn,Pulver,Pulver,Majority,Crosby,45,48,Mullen,47,47,Mullinax,47,48,-3,0,-1
2002-01-11,3,Suloev,Liddell,Liddell,Unanimous,Mullen,27,30,Mullinax,27,30,Shearer,27,30,-3,-3,-3
2002-01-11,3,Sobral,Randleman,Randleman,Unanimous,Crosby,26,30,Mullen,26,30,Shearer,25,30,-4,-4,-5
2002-01-11,3,Castillo,Brennan,Castillo,Unanimous,Crosby,30,26,Mullen,30,27,Shearer,30,28,4,3,2
2001-11-02,3,Baroni,Lindland,Lindland,Majority,Hamilton,28,29,Peoples,27,29,Rosales,28,28,-1,-2,0
2001-09-28,5,Matyushenko,Ortiz,Ortiz,Unanimous,Crosby,43,50,Hamilton,44,50,Mullen,44,50,-7,-6,-6
2001-09-28,5,Hallman,Pulver,Pulver,Unanimous,Crosby,47,49,Mullen,47,48,Peoples,47,48,-2,-1,-1
2001-09-28,3,Bustamante,Liddell,Liddell,Unanimous,Crosby,28,29,Schorle,27,29,Weeks,27,29,-1,-2,-2
2001-09-28,3,Iha,Thomas,Thomas,Unanimous,Mullen,28,29,Schorle,27,29,Weeks,28,29,-1,-2,-1
2001-09-28,3,Serra,Edwards,Serra,Majority,Hamilton,30,26,Mullen,30,27,Weeks,29,29,4,3,0
2001-09-28,5,Menne,Castillo,Menne,Unanimous,Crosby,49,43,Mullen,49,44,Weeks,49,45,6,5,4
2001-06-29,3,Kondo,Matyushenko,Matyushenko,Unanimous,Andujar,27,30,Crosby,26,30,Mullinax,27,30,-3,-4,-3
2001-05-04,3,DeSouza,Berger,DeSouza,Unanimous,Andujar,30,27,Crosby,29,28,Depasquale Jr.,29,28,3,1,1
